cod_ibge;localidades;periodos;leitos_total;leitos_hab;leitos sus;leitos_sus_hab;leitos não sus;leitos_naosus_hab
3500105;Adamantina;2024;195;5,618625022;138;3,976257708;57;1,642367314
3500303;Aguaí;2024;24;0,74941452;24;0,74941452;0;0
3500501;Águas de Lindóia;2024;42;2,341528684;30;1,672520488;12;0,669008195
3500709;Agudos;2024;54;1,427099025;38;1,004254869;16;0,422844156
3501004;Altinópolis;2024;21;1,244223249;19;1,125725797;2;0,118497452
3501103;Alto Alegre;2024;22;5,790997631;19;5,001316136;3;0,789681495
3501152;Alumínio;2024;120;6,945650287;0;0;120;6,945650287
3501301;Álvares Machado;2024;18;0,654664484;16;0,581923986;2;0,072740498
3501608;Americana;2024;411;1,720896541;143;0,598754758;268;1,122141783
3501707;Américo Brasiliense;2024;245;7,480230819;245;7,480230819;0;0
3501905;Amparo;2024;374;5,498787032;220;3,234580607;154;2,264206425
3502101;Andradina;2024;92;1,533026728;53;0,883156702;39;0,649870026
3502200;Angatuba;2024;57;2,363870112;54;2,239455895;3;0,124414216
3502507;Aparecida;2024;92;2,850768468;49;1,518344075;43;1,332424393
3502606;Aparecida d'Oeste;2024;13;3,219415552;12;2,971768202;1;0,24764735
3502705;Apiaí;2024;51;2,083588675;45;1,838460596;6;0,245128079
3502804;Araçatuba;2024;413;2,054184717;264;1,313086599;149;0,741098118
3502903;Araçoiaba da Serra;2024;330;10,05300676;0;0;330;10,05300676
3503109;Arandu;2024;6;0,86517664;6;0,86517664;0;0
3503208;Araraquara;2024;498;2,037968416;268;1,096738023;230;0,941230393
3503307;Araras;2024;422;3,209955426;228;1,734288713;194;1,475666712
3503406;Arealva;2024;26;3,190184049;15;1,840490798;11;1,349693252
3503802;Artur Nogueira;2024;8;0,153952737;8;0,153952737;0;0
3503901;Arujá;2024;36;0,411569681;36;0,411569681;0;0
3504008;Assis;2024;277;2,72463483;151;1,48527025;126;1,23936458
3504107;Atibaia;2024;310;1,925956299;66;0,410042309;244;1,515913991
3504206;Auriflama;2024;44;3,227226053;35;2,567111633;9;0,66011442
3504503;Avaré;2024;178;1,907435785;132;1,414502942;46;0,492932843
3504909;Bananal;2024;15;1,510726156;15;1,510726156;0;0
3505203;Bariri;2024;58;1,837187203;45;1,425403864;13;0,411783339
3505302;Barra Bonita;2024;51;1,491969693;36;1,053155077;15;0,438814615
3505500;Barretos;2024;486;3,946022312;413;3,353307027;73;0,592715286
3505708;Barueri;2024;621;1,930537939;495;1,538834589;126;0,39170335
3505807;Bastos;2024;30;1,392822322;18;0,835693393;12;0,557128929
3505906;Batatais;2024;133;2,275449102;101;1,727972626;32;0,547476476
3506003;Bauru;2024;1291;3,386709199;701;1,838948992;590;1,547760207
3506102;Bebedouro;2024;179;2,344804098;139;1,820825528;40;0,523978569
3506300;Bernardino de Campos;2024;27;2,317596567;27;2,317596567;0;0
3506359;Bertioga;2024;49;0,749533454;49;0,749533454;0;0
3506409;Bilac;2024;36;4,926782537;35;4,789927467;1;0,13685507
3506508;Birigui;2024;150;1,255272143;66;0,552319743;84;0,7029524
3506607;Biritiba Mirim;2024;13;0,437872613;13;0,437872613;0;0
3506706;Boa Esperança do Sul;2024;16;1,240791004;15;1,163241566;1;0,077549438
3506805;Bocaina;2024;18;1,598437084;18;1,598437084;0;0
3507001;Boituva;2024;67;1,079704773;52;0,837979824;15;0,241724949
3507100;Bom Jesus dos Perdões;2024;11;0,496210754;11;0,496210754;0;0
3507407;Borborema;2024;26;1,834344575;16;1,128827431;10;0,705517144
3507506;Botucatu;2024;820;5,607527764;511;3,49444718;309;2,113080584
3507605;Bragança Paulista;2024;364;2,033746787;202;1,128617723;162;0,905129065
3507902;Brotas;2024;41;1,7059876;35;1,456330878;6;0,249656722
3508108;Buritama;2024;38;2,195136041;24;1,38640171;14;0,808734331
3508405;Cabreúva;2024;66;1,391993926;15;0,316362256;51;1,07563167
3508504;Caçapava;2024;478;4,937608462;428;4,421122221;50;0,516486241
3508603;Cachoeira Paulista;2024;31;0,980888495;31;0,980888495;0;0
3508702;Caconde;2024;53;3,126290332;53;3,126290332;0;0
3508801;Cafelândia;2024;45;2,708559047;34;2,046466835;11;0,662092211
3509007;Caieiras;2024;142;1,4882512;81;0,848932023;61;0,639319177
3509205;Cajamar;2024;139;1,46636847;39;0,411427125;100;1,054941345
3509304;Cajobi;2024;32;3,533568905;27;2,981448763;5;0,552120141
3509403;Cajuru;2024;140;5,883588989;55;2,31140996;85;3,572179029
3509502;Campinas;2024;2846;2,496200005;1380;1,210385104;1466;1,285814901
3509601;Campo Limpo Paulista;2024;54;0,69529389;54;0,69529389;0;0
3509700;Campos do Jordão;2024;195;4,167824396;185;3,954089811;10;0,213734584
3510005;Cândido Mota;2024;30;1,022529739;25;0,852108115;5;0,170421623
3510203;Capão Bonito;2024;45;0,972678541;37;0,799757911;8;0,172920629
3510302;Capela do Alto;2024;45;1,935650379;0;0;45;1,935650379
3510401;Capivari;2024;104;2,075848303;61;1,21756487;43;0,858283433
3510500;Caraguatatuba;2024;327;2,381698071;259;1,886421408;68;0,495276663
3510609;Carapicuíba;2024;247;0,638873513;220;0,569037137;27;0,069836376
3510708;Cardoso;2024;31;2,744091352;10;0,885190759;21;1,858900593
3510807;Casa Branca;2024;247;8,812615955;239;8,527187099;8;0,285428857
3511003;Castilho;2024;31;1,543824701;30;1,494023904;1;0,049800797
3511102;Catanduva;2024;624;5,38827532;373;3,220876113;251;2,167399207
3511409;Cerqueira César;2024;38;1,748573532;35;1,610528253;3;0,138045279
3511508;Cerquilho;2024;38;0,845308538;26;0,578368999;12;0,266939538
3511607;Cesário Lange;2024;27;1,398528955;23;1,19133948;4;0,207189475
3511706;Charqueada;2024;35;2,252977148;26;1,673640167;9;0,579336981
3511904;Clementina;2024;24;3,452740613;21;3,021148036;3;0,431592577
3512001;Colina;2024;54;2,910580499;41;2,209885194;13;0,700695305
3512100;Colômbia;2024;20;3,003003003;20;3,003003003;0;0
3512209;Conchal;2024;50;1,77041286;40;1,416330288;10;0,354082572
3512308;Conchas;2024;15;0,993048659;14;0,926845415;1;0,066203244
3512605;Coronel Macedo;2024;2;0,475963827;2;0,475963827;0;0
3512704;Corumbataí;2024;2;0,475511175;2;0,475511175;0;0
3512803;Cosmópolis;2024;61;1,021655752;34;0,569447468;27;0,452208284
3513009;Cotia;2024;443;1,585846943;138;0,494011011;305;1,091835931
3513108;Cravinhos;2024;15;0,450815977;13;0,39070718;2;0,060108797
3513405;Cruzeiro;2024;121;1,623529096;83;1,113660454;38;0,509868642
3513504;Cubatão;2024;109;0,977149056;109;0,977149056;0;0
3513603;Cunha;2024;40;1,809136137;25;1,130710086;15;0,678426052
3513702;Descalvado;2024;40;1,258574036;25;0,786608772;15;0,471965263
3513801;Diadema;2024;488;1,244186995;449;1,144754018;39;0,099432977
3513900;Divinolândia;2024;186;16,72661871;186;16,72661871;0;0
3514106;Dois Córregos;2024;67;2,742080707;47;1,923549153;20;0,818531554
3514304;Dourado;2024;10;1,241619071;10;1,241619071;0;0
3514403;Dracena;2024;143;3,138098269;108;2,370032259;35;0,76806601
3514502;Duartina;2024;87;7,054816737;77;6,243918261;10;0,810898476
3514809;Eldorado;2024;2;0,155195158;2;0,155195158;0;0
3514908;Elias Fausto;2024;6;0,33675703;6;0,33675703;0;0
3515004;Embu das Artes;2024;99;0,395146484;89;0,355232697;10;0,039913786
3515103;Embu-Guaçu;2024;15;0,223950791;15;0,223950791;0;0
3515186;Espírito Santo do Pinhal;2024;696;17,58375019;617;15,58789349;79;1,995856703
3515202;Estrela d'Oeste;2024;51;5,368986209;12;1,263290873;39;4,105695336
3515400;Fartura;2024;20;1,198897015;12;0,719338209;8;0,479558806
3515509;Fernandópolis;2024;135;1,884948338;84;1,172856744;51;0,712091595
3515707;Ferraz de Vasconcelos;2024;189;1,053265122;189;1,053265122;0;0
3516002;Flórida Paulista;2024;47;3,636082315;30;2,320903605;17;1,31517871
3516200;Franca;2024;615;1,734891633;412;1,162236346;203;0,572655287
3516309;Francisco Morato;2024;157;0,949013208;157;0,949013208;0;0
3516408;Franco da Rocha;2024;434;2,981301606;384;2,637833679;50;0,343467927
3516606;Gália;2024;45;7,137192704;27;4,282315623;18;2,854877082
3516705;Garça;2024;269;6,4088819;221;5,265289591;48;1,143592309
3516903;General Salgado;2024;28;2,722411279;19;1,84735051;9;0,875060768
3517000;Getulina;2024;38;3,741262184;36;3,544353648;2;0,196908536
3517406;Guaíra;2024;51;1,295073641;38;0,964956831;13;0,330116811
3517604;Guapiara;2024;12;0,708926567;12;0,708926567;0;0
3517703;Guará;2024;50;2,71134971;46;2,494441733;4;0,216907977
3517802;Guaraçaí;2024;23;3,142076503;15;2,049180328;8;1,092896175
3518206;Guararapes;2024;74;2,39280864;48;1,552092091;26;0,840716549
3518305;Guararema;2024;31;0,981758297;29;0,918419052;2;0,063339245
3518404;Guaratinguetá;2024;283;2,39123271;166;1,402631201;117;0,988601509
3518602;Guariba;2024;61;1,625972918;53;1,412730568;8;0,21324235
3518701;Guarujá;2024;448;1,563617961;346;1,207615657;102;0,356002304
3518800;Guarulhos;2024;1955;1,51159599;1411;1,090977976;544;0,420618015
3519006;Herculândia;2024;58;6,342263532;58;6,342263532;0;0
3519071;Hortolândia;2024;98;0,408733552;76;0,31697704;22;0,091756512
3519105;Iacanga;2024;30;2,867246488;28;2,676096722;2;0,191149766
3519303;Ibaté;2024;28;0,869430213;27;0,838379134;1;0,031051079
3519402;Ibirá;2024;27;2,298654861;9;0,766218287;18;1,532436574
3519600;Ibitinga;2024;104;1,720657821;57;0,943052844;47;0,777604977
3519709;Ibiúna;2024;280;3,696223252;70;0,924055813;210;2,772167439
3519907;Iepê;2024;18;2,370292336;18;2,370292336;0;0
3520103;Igarapava;2024;43;1,652638457;32;1,229870479;11;0,422767977
3520202;Igaratá;2024;8;0,746199049;8;0,746199049;0;0
3520400;Ilhabela;2024;39;1,102598174;39;1,102598174;0;0
3520442;Ilha Solteira;2024;71;2,78453212;67;2,627657071;4;0,156875049
3520509;Indaiatuba;2024;454;1,748433534;271;1,043668475;183;0,704765059
3520707;Indiaporã;2024;36;8,895478132;4;0,988386459;32;7,907091673
3520905;Ipaussu;2024;49;3,57716455;28;2,044094028;21;1,533070521
3521002;Iperó;2024;15;0,405055087;15;0,405055087;0;0
3521309;Ipuã;2024;50;3,461405331;39;2,699896158;11;0,761509173
3521408;Iracemápolis;2024;3;0,135931128;3;0,135931128;0;0
3521705;Itaberá;2024;19;1,057553156;19;1,057553156;0;0
3521804;Itaí;2024;35;1,387457385;33;1,308174106;2;0,079283279
3521903;Itajobi;2024;50;2,90630086;35;2,034410602;15;0,871890258
3522109;Itanhaém;2024;141;1,234827387;137;1,199796823;4;0,035030564
3522208;Itapecerica da Serra;2024;633;3,998206176;195;1,231674888;438;2,766531288
3522307;Itapetininga;2024;216;1,36229471;173;1,091097152;43;0,271197558
3522406;Itapeva;2024;147;1,639344262;102;1,137504182;45;0,50184008
3522505;Itapevi;2024;360;1,538290617;224;0,957158606;136;0,581132011
3522604;Itapira;2024;900;12,46761882;528;7,314336376;372;5,153282447
3522703;Itápolis;2024;69;1,753271503;43;1,092618473;26;0,66065303
3522802;Itaporanga;2024;41;2,928989856;29;2,071724532;12;0,857265324
3522901;Itapuí;2024;35;2,538807486;35;2,538807486;0;0
3523107;Itaquaquecetuba;2024;273;0,733868995;267;0,717740006;6;0,016128989
3523206;Itararé;2024;78;1,769670569;51;1,157092295;27;0,612578274
3523404;Itatiba;2024;120;0,975855703;61;0,496059983;59;0,479795721
3523503;Itatinga;2024;14;0,733253025;7;0,366626512;7;0,366626512
3523602;Itirapina;2024;10;0,6177797;10;0,6177797;0;0
3523909;Itu;2024;463;2,740974911;351;2,077931304;112;0,663043607
3524006;Itupeva;2024;86;1,184638272;48;0,661193454;38;0,523444818
3524105;Ituverava;2024;124;3,313204724;61;1,629882969;63;1,683321755
3524204;Jaborandi;2024;17;2,753482345;17;2,753482345;0;0
3524303;Jaboticabal;2024;277;3,863912176;46;0,641660506;231;3,22225167
3524402;Jacareí;2024;324;1,339108584;165;0,681953445;159;0,657155138
3524501;Jaci;2024;216;27,92140641;168;21,71664943;48;6,20475698
3524709;Jaguariúna;2024;117;1,936444886;84;1,390268123;33;0,546176763
3524808;Jales;2024;151;3,09204464;103;2,109143033;48;0,982901607
3525003;Jandira;2024;15;0,12669882;0;0;15;0,12669882
3525201;Jarinu;2024;29;0,752445448;17;0,441088711;12;0,311356737
3525300;Jaú;2024;876;6,559439303;569;4,260640369;307;2,298798934
3525508;Joanópolis;2024;12;0,934870676;12;0,934870676;0;0
3525706;José Bonifácio;2024;67;1,81625959;43;1,16565914;24;0,65060045
3525904;Jundiaí;2024;979;2,184906957;457;1,019920817;522;1,164986141
3526001;Junqueirópolis;2024;46;2,241933912;25;1,218442343;21;1,023491568
3526209;Juquitiba;2024;1;0,03677958;1;0,03677958;0;0
3526407;Laranjal Paulista;2024;46;1,748384645;28;1,064234132;18;0,684150513
3526704;Leme;2024;135;1,372327773;77;0,7827351;58;0,589592673
3526803;Lençóis Paulista;2024;171;2,558769397;43;0,64343324;128;1,915336156
3526902;Limeira;2024;404;1,380564118;172;0,587764921;232;0,792799196
3527108;Lins;2024;352;4,702236234;279;3,72705656;73;0,975179674
3527207;Lorena;2024;200;2,357656489;106;1,249557939;94;1,10809855
3527306;Louveira;2024;39;0,737226139;35;0,661613202;4;0,075612937
3527405;Lucélia;2024;36;1,79973004;30;1,499775034;6;0,299955007
3528007;Macatuba;2024;31;1,844359829;18;1,07091861;13;0,773441218
3528106;Macaubal;2024;15;2,015045674;10;1,343363783;5;0,671681891
3528502;Mairiporã;2024;44;0,465441005;44;0,465441005;0;0
3528809;Maracaí;2024;26;2,071548084;22;1,752848379;4;0,318699705
3529005;Marília;2024;880;3,688150141;584;2,447590548;296;1,240559593
3529203;Martinópolis;2024;38;1,527945316;34;1,367108967;4;0,160836349
3529302;Matão;2024;151;1,910956997;87;1,101014959;64;0,809942039
3529401;Mauá;2024;502;1,203704148;261;0,625830244;241;0,577873904
3529708;Miguelópolis;2024;72;3,73211694;51;2,643582832;21;1,088534107
3529807;Mineiros do Tietê;2024;11;0,986370158;11;0,986370158;0;0
3530102;Mirandópolis;2024;88;3,151072439;88;3,151072439;0;0
3530201;Mirante do Paranapanema;2024;23;1,457448831;23;1,457448831;0;0
3530300;Mirassol;2024;79;1,234162878;28;0,437424818;51;0,796738061
3530508;Mococa;2024;137;2,026357438;78;1,153692556;59;0,872664882
3530607;Mogi das Cruzes;2024;854;1,876444687;593;1,302964519;261;0,573480168
3530706;Mogi Guaçu;2024;331;2,142159115;155;1,00312587;176;1,139033246
3530805;Mogi Mirim;2024;172;1,853628046;109;1,17468289;63;0,678945156
3531100;Mongaguá;2024;36;0,571283484;36;0,571283484;0;0
3531308;Monte Alto;2024;96;2,019861976;49;1,030971217;47;0,988890759
3531407;Monte Aprazível;2024;80;3,582945181;30;1,343604443;50;2,239340738
3531506;Monte Azul Paulista;2024;70;3,878116343;51;2,825484765;19;1,052631579
3531803;Monte Mor;2024;35;0,532619116;26;0,395659915;9;0,136959201
3531902;Morro Agudo;2024;47;1,690890776;35;1,259173982;12;0,431716794
3532009;Morungaba;2024;8;0,575663812;8;0,575663812;0;0
3532405;Nazaré Paulista;2024;22;1,201857416;22;1,201857416;0;0
3532504;Neves Paulista;2024;21;2,156057495;10;1,026694045;11;1,12936345
3532603;Nhandeara;2024;129;13,20909277;35;3,58386238;94;9,625230391
3532900;Nova Europa;2024;16;1,726184054;12;1,294638041;4;0,431546014
3533007;Nova Granada;2024;62;3,195711561;31;1,597855781;31;1,597855781
3533403;Nova Odessa;2024;35;0,558115801;35;0,558115801;0;0
3533502;Novo Horizonte;2024;73;1,901487328;41;1,067958636;32;0,833528692
3533908;Olímpia;2024;79;1,425864092;47;0,84829889;32;0,577565202
3534302;Orlândia;2024;98;2,573799769;60;1,575795777;38;0,998003992
3534401;Osasco;2024;978;1,337660899;636;0,86988991;342;0,467770989
3534609;Osvaldo Cruz;2024;97;3,104695452;63;2,016451685;34;1,088243767
3534708;Ourinhos;2024;171;1,649305556;101;0,974151235;70;0,675154321
3534757;Ouroeste;2024;33;3,171856978;28;2,691272587;5;0,480584391
3535200;Palmeira d'Oeste;2024;20;2,262187535;12;1,357312521;8;0,904875014
3535309;Palmital;2024;43;2,212161745;29;1,491923037;14;0,720238708
3535507;Paraguaçu Paulista;2024;96;2,347532645;73;1,785102949;23;0,562429696
3535804;Paranapanema;2024;15;0,768521365;15;0,768521365;0;0
3536000;Parapuã;2024;32;3,036917529;26;2,467495492;6;0,569422037
3536208;Pariquera-Açu;2024;139;7,220029088;139;7,220029088;0;0
3536307;Patrocínio Paulista;2024;35;2,399890291;23;1,577070762;12;0,822819528
3536505;Paulínia;2024;79;0,701922735;79;0,701922735;0;0
3536604;Paulo de Faria;2024;24;3,282724661;18;2,462043496;6;0,820681165
3536703;Pederneiras;2024;62;1,376156971;54;1,198588329;8;0,177568641
3537008;Pedregulho;2024;64;4,129298664;55;3,54861604;9;0,580682625
3537107;Pedreira;2024;77;1,782654998;77;1,782654998;0;0
3537206;Pedro de Toledo;2024;3;0,264550265;3;0,264550265;0;0
3537305;Penápolis;2024;138;2,232829059;120;1,941590486;18;0,291238573
3537404;Pereira Barreto;2024;52;2,170918048;47;1,962175928;5;0,20874212
3537602;Peruíbe;2024;18;0,261434111;15;0,217861759;3;0,043572352
3537800;Piedade;2024;79;1,493242605;59;1,115206502;20;0,378036102
3537909;Pilar do Sul;2024;35;1,267381228;27;0,97769409;8;0,289687138
3538006;Pindamonhangaba;2024;255;1,530097926;129;0,774049539;126;0,756048387
3538600;Piracaia;2024;62;2,378212505;28;1,074031454;34;1,304181051
3538709;Piracicaba;2024;766;1,793516181;385;0,901440901;381;0,892075281
3538808;Piraju;2024;68;2,31426335;49;1,667630943;19;0,646632406
3538907;Pirajuí;2024;290;12,98526844;85;3,806026956;205;9,179241481
3539004;Pirangi;2024;47;4,306395455;22;2,015759575;25;2,290635881
3539301;Pirassununga;2024;184;2,497794068;66;0,895947872;118;1,601846196
3539400;Piratininga;2024;25;1,631002088;21;1,370041754;4;0,260960334
3539509;Pitangueiras;2024;56;1,672740307;32;0,955851604;24;0,716888703
3540002;Pompéia;2024;26;1,290066488;19;0,942740895;7;0,347325593
3540200;Pontal;2024;23;0,616241996;19;0,509069475;4;0,107172521
3540408;Populina;2024;18;4,373177843;6;1,457725948;12;2,915451895
3540606;Porto Feliz;2024;82;1,439808962;71;1,246663857;11;0,193145105
3540705;Porto Ferreira;2024;55;1,045945535;33;0,627567321;22;0,418378214
3540804;Potirendaba;2024;32;1,709401709;28;1,495726496;4;0,213675214
3541000;Praia Grande;2024;380;1,067253844;218;0,612266679;162;0,454987165
3541208;Presidente Bernardes;2024;51;3,514817367;41;2,825637491;10;0,689179876
3541307;Presidente Epitácio;2024;78;1,988629121;68;1,733676669;10;0,254952451
3541406;Presidente Prudente;2024;1109;4,897933946;735;3,246150992;374;1,651782954
3541505;Presidente Venceslau;2024;102;2,928173623;62;1,779870242;40;1,148303382
3541604;Promissão;2024;64;1,830087787;64;1,830087787;0;0
3541901;Queluz;2024;19;2,119589469;19;2,119589469;0;0
3542206;Rancharia;2024;103;3,614542392;71;2,491577765;32;1,122964627
3542404;Regente Feijó;2024;43;2,126081582;34;1,681087763;9;0,44499382
3542602;Registro;2024;228;3,786683496;179;2,97287871;49;0,813804787
3542909;Ribeirão Bonito;2024;13;1,197935864;10;0,921489126;3;0,276446738
3543006;Ribeirão Branco;2024;26;1,396348013;26;1,396348013;0;0
3543303;Ribeirão Pires;2024;156;1,351913478;42;0,363976705;114;0,987936772
3543402;Ribeirão Preto;2024;2249;3,190641164;1481;2,101084733;768;1,089556431
3543808;Rinópolis;2024;24;2,609546591;23;2,500815483;1;0,108731108
3543907;Rio Claro;2024;394;1,948787449;217;1,073316945;177;0,875470504
3544004;Rio das Pedras;2024;72;2,291606989;64;2,036983991;8;0,254622999
3544202;Riolândia;2024;36;3,509113949;25;2,436884687;11;1,072229262
3544251;Rosana;2024;70;4,068821204;70;4,068821204;0;0
3544301;Roseira;2024;14;1,28440367;14;1,28440367;0;0
3544905;Sales Oliveira;2024;30;2,617801047;20;1,745200698;10;0,872600349
3545001;Salesópolis;2024;9;0,594216295;9;0,594216295;0;0
3545209;Salto;2024;116;0,850595784;116;0,850595784;0;0
3545308;Salto de Pirapora;2024;56;1,273624599;47;1,068934931;9;0,204689668
3545407;Salto Grande;2024;34;3,757321251;22;2,431207868;12;1,326113383
3545605;Santa Adélia;2024;23;1,646149442;19;1,359862582;4;0,286286859
3545803;Santa Bárbara d'Oeste;2024;203;1,107570764;123;0,671089675;80;0,436481089
3546306;Santa Cruz das Palmeiras;2024;34;1,183102512;25;0,869928318;9;0,313174194
3546405;Santa Cruz do Rio Pardo;2024;96;2,06278605;55;1,181804508;41;0,880981542
3546603;Santa Fé do Sul;2024;81;2,30467194;58;1,65025892;23;0,65441302
3546801;Santa Isabel;2024;82;1,540426811;71;1,33378419;11;0,206642621
3546900;Santa Lúcia;2024;8;1,134912754;0;0;8;1,134912754
3547007;Santa Maria da Serra;2024;6;1,152737752;6;1,152737752;0;0
3547304;Santana de Parnaíba;2024;62;0,393913403;62;0,393913403;0;0
3547502;Santa Rita do Passa Quatro;2024;251;10,17512567;239;9,688665478;12;0,486460191
3547601;Santa Rosa de Viterbo;2024;32;1,372801373;19;0,815100815;13;0,557700558
3547700;Santo Anastácio;2024;56;3,157063931;37;2,08591724;19;1,071146691
3547809;Santo André;2024;1561;2,073635997;748;0,993644923;813;1,079991073
3547908;Santo Antônio da Alegria;2024;9;1,322556943;9;1,322556943;0;0
3548500;Santos;2024;1645;3,93733769;732;1,752055434;913;2,185282256
3548609;São Bento do Sapucaí;2024;40;3,408025901;26;2,215216836;14;1,192809065
3548708;São Bernardo do Campo;2024;1749;2,156070405;669;0,824706175;1080;1,331364229
3548807;São Caetano do Sul;2024;812;4,879866345;193;1,15986971;619;3,719996635
3548906;São Carlos;2024;381;1,483974247;199;0,77509416;182;0,708880086
3549102;São João da Boa Vista;2024;190;2,03948004;92;0,987537704;98;1,051942336
3549409;São Joaquim da Barra;2024;95;1,951760694;70;1,438139458;25;0,513621235
3549706;São José do Rio Pardo;2024;141;2,706126209;79;1,516198372;62;1,189927837
3549805;São José do Rio Preto;2024;2224;4,582203578;1105;2,276679386;1119;2,305524193
3549904;São José dos Campos;2024;1554;2,219014124;743;1,060957203;811;1,15805692
3549953;São Lourenço da Serra;2024;60;3,707136237;0;0;60;3,707136237
3550001;São Luiz do Paraitinga;2024;25;2,417794971;16;1,547388781;9;0,87040619
3550100;São Manuel;2024;58;1,561112158;42;1,130460528;16;0,43065163
3550209;São Miguel Arcanjo;2024;80;2,497580469;80;2,497580469;0;0
3550308;São Paulo;2024;30465;2,665385812;15507;1,356708938;14958;1,308676874
3550407;São Pedro;2024;63;1,628580292;51;1,318374522;12;0,31020577
3550605;São Roque;2024;263;3,315181768;62;0,78152574;201;2,533656028
3550704;São Sebastião;2024;106;1,293345372;106;1,293345372;0;0
3550803;São Sebastião da Grama;2024;30;2,913752914;26;2,525252525;4;0,388500389
3550902;São Simão;2024;40;3,004581988;36;2,704123789;4;0,300458199
3551009;São Vicente;2024;283;0,861297607;191;0,581299799;92;0,279997809
3551504;Serrana;2024;84;1,89796195;82;1,85277238;2;0,04518957
3551603;Serra Negra;2024;49;1,631647298;33;1,098864507;16;0,532782791
3551702;Sertãozinho;2024;134;1,047660746;61;0,47692019;73;0,570740555
3552007;Silveiras;2024;2;0,321905682;2;0,321905682;0;0
3552106;Socorro;2024;95;2,360013912;63;1,565061857;32;0,794952054
3552205;Sorocaba;2024;1685;2,297828586;911;1,242327503;774;1,055501083
3552304;Sud Mennucci;2024;22;3,005053954;20;2,731867231;2;0,273186723
3552403;Sumaré;2024;191;0,678019048;182;0,646070507;9;0,031948542
3552502;Suzano;2024;326;1,050748578;173;0,55760584;153;0,493142737
3552601;Tabapuã;2024;30;2,654397452;11;0,973279066;19;1,681118386
3552700;Tabatinga;2024;35;2,375296912;22;1,493043773;13;0,882253139
3552809;Taboão da Serra;2024;436;1,588128376;328;1,194738778;108;0,393389598
3553005;Taguaí;2024;29;2,270236418;24;1,878816346;5;0,391420072
3553203;Taiúva;2024;4;0,603682463;4;0,603682463;0;0
3553302;Tambaú;2024;36;1,687684591;28;1,31264357;8;0,37504102
3553401;Tanabi;2024;72;2,840348732;30;1,183478638;42;1,656870093
3553609;Tapiratiba;2024;16;1,366470237;15;1,281065847;1;0,08540439
3553708;Taquaritinga;2024;122;2,346875962;74;1,423514928;48;0,923361034
3553807;Taquarituba;2024;47;1,922133159;32;1,308686406;15;0,613446753
3554003;Tatuí;2024;195;1,558628407;78;0,623451363;117;0,935177044
3554102;Taubaté;2024;532;1,702857728;367;1,174715764;165;0,528141965
3554300;Teodoro Sampaio;2024;58;2,622772904;52;2,351451569;6;0,271321335
3554409;Terra Roxa;2024;34;4,324599339;30;3,815822946;4;0,508776393
3554508;Tietê;2024;55;1,459582825;33;0,875749695;22;0,58383313
3554706;Torrinha;2024;20;2,145692522;13;1,394700139;7;0,750992383
3554805;Tremembé;2024;10;0,193039013;0;0;10;0,193039013
3555000;Tupã;2024;344;5,388386773;328;5,137764133;16;0,250622641
3555109;Tupi Paulista;2024;48;3,01072571;30;1,881703569;18;1,129022141
3555406;Ubatuba;2024;77;0,819070515;69;0,733972279;8;0,085098235
3555802;Urânia;2024;26;2,947177511;24;2,720471548;2;0,226705962
3556008;Urupês;2024;20;1,448960371;10;0,724480185;10;0,724480185
3556206;Valinhos;2024;142;1,112059581;56;0,438558708;86;0,673500873
3556305;Valparaíso;2024;52;2,141327623;32;1,317740076;20;0,823587547
3556404;Vargem Grande do Sul;2024;50;1,245981709;31;0,77250866;19;0,473473049
3556453;Vargem Grande Paulista;2024;93;1,828009828;2;0,039312039;91;1,788697789
3556503;Várzea Paulista;2024;33;0,284225486;31;0,266999699;2;0,017225787
3556602;Vera Cruz;2024;72;7,111111111;0;0;72;7,111111111
3556701;Vinhedo;2024;85;1,098162838;62;0,801012894;23;0,297149944
3556800;Viradouro;2024;48;2,759413625;30;1,724633515;18;1,034780109
3557006;Votorantim;2024;162;1,253336428;64;0,495145256;98;0,758191172
3557105;Votuporanga;2024;208;2,133617816;115;1,179644465;93;0,95397335
3557204;Chavantes;2024;51;4,193044479;30;2,466496752;21;1,726547727
3500303;Aguaí;2023;24;0,7;24;0,7;0;0,0
3501707;Américo Brasiliense;2023;253;7,7;253;7,7;0;0,0
3503109;Arandu;2023;6;0,9;6;0,9;0;0,0
3503802;Artur Nogueira;2023;8;0,2;8;0,2;0;0,0
3503901;Arujá;2023;36;0,4;36;0,4;0;0,0
3504909;Bananal;2023;15;1,5;15;1,5;0;0,0
3506300;Bernardino de Campos;2023;23;2,0;23;2,0;0;0,0
3506359;Bertioga;2023;49;0,7;49;0,7;0;0,0
3506607;Biritiba Mirim;2023;13;0,4;13;0,4;0;0,0
3506805;Bocaina;2023;18;1,6;18;1,6;0;0,0
3507100;Bom Jesus dos Perdões;2023;11;0,5;11;0,5;0;0,0
3508603;Cachoeira Paulista;2023;32;1,0;32;1,0;0;0,0
3508702;Caconde;2023;50;2,9;50;2,9;0;0,0
3509601;Campo Limpo Paulista;2023;54;0,7;54;0,7;0;0,0
3512100;Colômbia;2023;20;3,0;20;3,0;0;0,0
3512605;Coronel Macedo;2023;2;0,5;2;0,5;0;0,0
3512704;Corumbataí;2023;2;0,5;2;0,5;0;0,0
3513504;Cubatão;2023;119;1,1;119;1,1;0;0,0
3513900;Divinolândia;2023;186;16,7;186;16,7;0;0,0
3514304;Dourado;2023;15;1,9;15;1,9;0;0,0
3514809;Eldorado;2023;2;0,2;2;0,2;0;0,0
3514908;Elias Fausto;2023;6;0,3;6;0,3;0;0,0
3515103;Embu-Guaçu;2023;15;0,2;15;0,2;0;0,0
3515707;Ferraz de Vasconcelos;2023;189;1,1;189;1,1;0;0,0
3516309;Francisco Morato;2023;168;1,0;168;1,0;0;0,0
3519006;Herculândia;2023;58;6,3;58;6,3;0;0,0
3519907;Iepê;2023;18;2,4;18;2,4;0;0,0
3520202;Igaratá;2023;8;0,7;8;0,7;0;0,0
3520400;Ilhabela;2023;39;1,1;39;1,1;0;0,0
3521002;Iperó;2023;15;0,4;15;0,4;0;0,0
3521408;Iracemápolis;2023;3;0,1;3;0,1;0;0,0
3521705;Itaberá;2023;19;1,1;19;1,1;0;0,0
3521804;Itaí;2023;31;1,2;31;1,2;0;0,0
3522109;Itanhaém;2023;145;1,3;145;1,3;0;0,0
3522901;Itapuí;2023;35;2,5;35;2,5;0;0,0
3523602;Itirapina;2023;10;0,6;10;0,6;0;0,0
3524204;Jaborandi;2023;17;2,8;17;2,8;0;0,0
3524709;Jaguariúna;2023;84;1,4;84;1,4;0;0,0
3525508;Joanópolis;2023;11;0,9;11;0,9;0;0,0
3526209;Juquitiba;2023;1;0,0;1;0,0;0;0,0
3528502;Mairiporã;2023;44;0,5;44;0,5;0;0,0
3529807;Mineiros do Tietê;2023;11;1,0;11;1,0;0;0,0
3530102;Mirandópolis;2023;88;3,2;88;3,2;0;0,0
3530201;Mirante do Paranapanema;2023;23;1,5;23;1,5;0;0,0
3531100;Mongaguá;2023;36;0,6;36;0,6;0;0,0
3532405;Nazaré Paulista;2023;20;1,1;20;1,1;0;0,0
3533403;Nova Odessa;2023;35;0,6;35;0,6;0;0,0
3535804;Paranapanema;2023;15;0,8;15;0,8;0;0,0
3536208;Pariquera-Açu;2023;154;8,0;154;8,0;0;0,0
3536505;Paulínia;2023;79;0,7;79;0,7;0;0,0
3537206;Pedro de Toledo;2023;3;0,3;3;0,3;0;0,0
3539806;Poá;2023;10;0,1;10;0,1;0;0,0
3541604;Promissão;2023;64;1,8;64;1,8;0;0,0
3541901;Queluz;2023;19;2,1;19;2,1;0;0,0
3543006;Ribeirão Branco;2023;26;1,4;26;1,4;0;0,0
3544251;Rosana;2023;80;4,7;80;4,7;0;0,0
3544301;Roseira;2023;14;1,3;14;1,3;0;0,0
3545001;Salesópolis;2023;9;0,6;9;0,6;0;0,0
3545209;Salto;2023;116;0,9;116;0,9;0;0,0
3547007;Santa Maria da Serra;2023;6;1,2;6;1,2;0;0,0
3547304;Santana de Parnaíba;2023;62;0,4;62;0,4;0;0,0
3547908;Santo Antonio da Alegria;2023;9;1,3;9;1,3;0;0,0
3550209;São Miguel Arcanjo;2023;80;2,5;80;2,5;0;0,0
3552007;Silveiras;2023;2;0,3;2;0,3;0;0,0
3553203;Taiúva;2023;4;0,6;4;0,6;0;0,0
3507407;Borborema;2023;26;1,8;16;1,1;10;0,7
3509700;Campos do Jordão;2023;195;4,2;185;4,0;10;0,2
3514502;Duartina;2023;87;7,1;77;6,2;10;0,8
3537107;Pedreira;2023;85;2,0;75;1,7;10;0,2
3541307;Presidente Epitácio;2023;78;2,0;68;1,7;10;0,3
3544905;Sales Oliveira;2023;30;2,6;20;1,7;10;0,9
3546306;Santa Cruz das Palmeiras;2023;35;1,2;25;0,9;10;0,3
3554805;Tremembé;2023;10;0,2;0;0,0;10;0,2
3556008;Urupês;2023;20;1,4;10;0,7;10;0,7
3505807;Bastos;2023;30;1,4;23;1,1;7;0,3
3511706;Charqueada;2023;33;2,1;26;1,7;7;0,5
3521309;Ipuã;2023;50;3,5;43;3,0;7;0,5
3523503;Itatinga;2023;14;0,7;7;0,4;7;0,4
3540002;Pompéia;2023;26;1,3;19;0,9;7;0,3
3552106;Socorro;2023;70;1,7;63;1,6;7;0,2
3554706;Torrinha;2023;20;2,1;13;1,4;7;0,8
3502705;Apiaí;2023;51;2,1;45;1,8;6;0,2
3507902;Brotas;2023;41;1,7;35;1,5;6;0,2
3515202;Estrela d'Oeste;2023;51;5,4;45;4,7;6;0,6
3523107;Itaquaquecetuba;2023;273;0,7;267;0,7;6;0,0
3536000;Parapuã;2023;32;3,0;26;2,5;6;0,6
3536604;Paulo de Faria;2023;24;3,3;18;2,5;6;0,8
3554300;Teodoro Sampaio;2023;58;2,6;52;2,4;6;0,3
3510203;Capão Bonito;2023;45;1,0;37;0,8;8;0,2
3510807;Casa Branca;2023;406;14,5;398;14,2;8;0,3
3515400;Fartura;2023;20;1,2;12;0,7;8;0,5
3517703;Guará;2023;60;3,3;52;2,8;8;0,4
3517802;Guaraçai;2023;23;3,1;15;2,0;8;1,1
3518602;Guariba;2023;61;1,6;53;1,4;8;0,2
3535200;Palmeira d'Oeste;2023;20;2,3;12;1,4;8;0,9
3536703;Pederneiras;2023;62;1,4;54;1,2;8;0,2
3537909;Pilar do Sul;2023;35;1,3;27;1,0;8;0,3
3544004;Rio das Pedras;2023;72;2,3;64;2,0;8;0,3
3545605;Santa Adélia;2023;19;1,4;11;0,8;8;0,6
3546900;Santa Lucia;2023;8;1,1;0;0,0;8;1,1
3553302;Tambaú;2023;36;1,7;28;1,3;8;0,4
3510005;Cândido Mota;2023;30;1,0;25;0,9;5;0,2
3528106;Macaubal;2023;15;2,0;10;1,3;5;0,7
3529203;Martinópolis;2023;45;1,8;40;1,6;5;0,2
3532900;Nova Europa;2023;18;1,9;13;1,4;5;0,5
3534757;Ouroeste;2023;33;3,2;28;2,7;5;0,5
3537404;Pereira Barreto;2023;52;2,2;47;2,0;5;0,2
3553005;Taguaí;2023;29;2,3;24;1,9;5;0,4
3501004;Altinópolis;2023;21;1,2;19;1,1;2;0,1
3501301;Álvares Machado;2023;18;0,7;16;0,6;2;0,1
3513108;Cravinhos;2023;15;0,5;13;0,4;2;0,1
3517000;Getulina;2023;38;3,7;36;3,5;2;0,2
3518305;Guararema;2023;31;1,0;29;0,9;2;0,1
3519105;Iacanga;2023;30;2,9;28;2,7;2;0,2
3539400;Piratininga;2023;23;1,5;21;1,4;2;0,1
3551504;Serrana;2023;84;1,9;82;1,9;2;0,0
3552304;Sud Mennucci;2023;22;3,0;20;2,7;2;0,3
3555802;Urânia;2023;26;2,9;24;2,7;2;0,2
3556503;Várzea Paulista;2023;33;0,3;31;0,3;2;0,0
3531506;Monte Azul Paulista;2023;70;3,9;51;2,8;19;1,1
3538808;Piraju;2023;68;2,3;49;1,7;19;0,6
3547700;Santo Anastácio;2023;56;3,2;37;2,1;19;1,1
3552601;Tabapuã;2023;30;2,7;11;1,0;19;1,7
3556404;Vargem Grande do Sul;2023;50;1,2;31;0,8;19;0,5
3516606;Gália;2023;45;7,1;27;4,3;18;2,9
3517406;Guaíra;2023;71;1,8;53;1,3;18;0,5
3519402;Ibirá;2023;27;2,3;9;0,8;18;1,5
3526407;Laranjal Paulista;2023;46;1,7;28;1,1;18;0,7
3537305;Penápolis;2023;138;2,2;120;1,9;18;0,3
3540606;Porto Feliz;2023;63;1,1;45;0,8;18;0,3
3511508;Cerquilho;2023;38;0,8;26;0,6;12;0,3
3512209;Conchal;2023;52;1,8;40;1,4;12;0,4
3522802;Itaporanga;2023;41;2,9;29;2,1;12;0,9
3525201;Jarinu;2023;29;0,8;17;0,4;12;0,3
3531902;Morro Agudo;2023;47;1,7;35;1,3;12;0,4
3536307;Patrocínio Paulista;2023;35;2,4;23;1,6;12;0,8
3540408;Populina;2023;18;4,4;6;1,5;12;2,9
3545407;Salto Grande;2023;34;3,8;22;2,4;12;1,3
3547502;Santa Rita do Passa Quatro;2023;265;10,7;253;10,3;12;0,5
3550407;São Pedro;2023;63;1,6;51;1,3;12;0,3
3550704;São Sebastião;2023;111;1,4;99;1,2;12;0,1
3511607;Cesário Lange;2023;27;1,4;23;1,2;4;0,2
3527306;Louveira;2023;32;0,6;28;0,5;4;0,1
3528809;Maracaí;2023;26;2,1;22;1,8;4;0,3
3540200;Pontal;2023;23;0,6;19;0,5;4;0,1
3540804;Potirendaba;2023;32;1,7;28;1,5;4;0,2
3550803;São Sebastião da Grama;2023;30;2,9;26;2,5;4;0,4
3550902;São Simão;2023;40;3,0;36;2,7;4;0,3
3501103;Alto Alegre;2023;22;5,8;19;5,0;3;0,8
3502200;Angatuba;2023;57;2,4;54;2,2;3;0,1
3511409;Cerqueira César;2023;38;1,7;35;1,6;3;0,1
3511904;Clementina;2023;24;3,5;21;3,0;3;0,4
3537602;Peruíbe;2023;18;0,3;15;0,2;3;0,0
3542909;Ribeirão Bonito;2023;13;1,2;10;0,9;3;0,3
3543808;Rinópolis;2023;23;2,5;20;2,2;3;0,3
3555406;Ubatuba;2023;86;0,9;83;0,9;3;0,0
3508801;Cafelândia;2023;45;2,7;34;2,0;11;0,7
3509304;Cajobi;2023;32;3,5;21;2,3;11;1,2
3519303;Ibaté;2023;38;1,2;27;0,8;11;0,3
3520103;Igarapava;2023;43;1,7;32;1,2;11;0,4
3532504;Neves Paulista;2023;21;2,2;10;1,0;11;1,1
3541208;Presidente Bernardes;2023;51;3,5;40;2,8;11;0,8
3544202;Riolândia;2023;36;3,5;25;2,4;11;1,1
3546801;Santa Isabel;2023;82;1,5;71;1,3;11;0,2
3505203;Bariri;2023;58;1,8;45;1,4;13;0,4
3512001;Colina;2023;54;2,9;41;2,2;13;0,7
3528007;Macatuba;2023;31;1,8;18;1,1;13;0,8
3547601;Santa Rosa do Viterbo;2023;32;1,4;19;0,8;13;0,6
3552700;Tabatinga;2023;35;2,4;22;1,5;13;0,9
3510708;Cardoso;2023;31;2,7;10;0,9;21;1,9
3520905;Ipaussu;2023;49;3,6;28;2,0;21;1,5
3526001;Junqueirópolis;2023;46;2,2;25;1,2;21;1,0
3529708;Miguelópolis;2023;72;3,7;51;2,6;21;1,1
3504206;Auriflama;2023;44;3,2;35;2,6;9;0,7
3516903;General Salgado;2023;28;2,7;19;1,8;9;0,9
3531803;Monte Mor;2023;35;0,5;26;0,4;9;0,1
3537008;Pedregulho;2023;64;4,1;55;3,5;9;0,6
3542404;Regente Feijó;2023;40;2,0;31;1,5;9;0,4
3545308;Salto de Pirapora;2023;52;1,2;43;1,0;9;0,2
3550001;São Luís do Paraitinga;2023;25;2,4;16;1,5;9;0,9
3552403;Sumaré;2023;191;0,7;182;0,6;9;0,0
3514106;Dois Córregos;2023;67;2,7;47;1,9;20;0,8
3537800;Piedade;2023;79;1,5;59;1,1;20;0,4
3505302;Barra Bonita;2023;51;1,5;36;1,1;15;0,4
3507001;Boituva;2023;54;0,9;39;0,6;15;0,2
3513603;Cunha;2023;40;1,8;25;1,1;15;0,7
3513702;Descalvado;2023;40;1,3;25;0,8;15;0,5
3521903;Itajobi;2023;50;2,9;35;2,0;15;0,9
3525003;Jandira;2023;15;0,1;0;0,0;15;0,1
3553807;Taquarituba;2023;47;1,9;32;1,3;15;0,6
3500105;Adamantina;2023;195;5,6;138;4,0;57;1,6
3500709;Agudos;2023;54;1,4;38;1,0;16;0,4
3501152;Alumínio;2023;120;6,9;0;0,0;120;6,9
3501608;Americana;2023;440;1,8;154;0,6;286;1,2
3501905;Amparo;2023;374;5,5;216;3,2;158;2,3
3502101;Andradina;2023;108;1,8;69;1,1;39;0,6
3502507;Aparecida;2023;92;2,9;69;2,1;23;0,7
3502606;Aparecida d'Oeste;2023;14;3,5;13;3,2;1;0,2
3502804;Araçatuba;2023;418;2,1;269;1,3;149;0,7
3502903;Araçoiaba da Serra;2023;330;10,1;45;1,4;285;8,7
3503208;Araraquara;2023;484;2,0;254;1,0;230;0,9
3503307;Araras;2023;418;3,2;165;1,3;253;1,9
3503406;Arealva;2023;32;3,9;15;1,8;17;2,1
3504008;Assis;2023;277;2,7;151;1,5;126;1,2
3504107;Atibaia;2023;266;1,7;60;0,4;206;1,3
3504503;Avaré;2023;178;1,9;132;1,4;46;0,5
3505500;Barretos;2023;486;3,9;413;3,4;73;0,6
3505708;Barueri;2023;524;1,6;430;1,3;94;0,3
3505906;Batatais;2023;133;2,3;101;1,7;32;0,5
3506003;Bauru;2023;1.329;3,5;761;2,0;568;1,5
3506102;Bebedouro;2023;175;2,3;137;1,8;38;0,5
3506409;Bilac;2023;36;4,9;35;4,8;1;0,1
3506508;Birigui;2023;148;1,2;66;0,6;82;0,7
3506706;Boa Esperança do Sul;2023;16;1,2;15;1,2;1;0,1
3507506;Botucatu;2023;820;5,6;511;3,5;309;2,1
3507605;Bragança Paulista;2023;364;2,0;203;1,1;161;0,9
3508108;Buritama;2023;40;2,3;26;1,5;14;0,8
3508405;Cabreúva;2023;66;1,4;15;0,3;51;1,1
3508504;Caçapava;2023;199;2,1;75;0,8;124;1,3
3509007;Caieiras;2023;122;1,3;69;0,7;53;0,6
3509205;Cajamar;2023;139;1,5;39;0,4;100;1,1
3509403;Cajuru;2023;140;5,9;55;2,3;85;3,6
3509502;Campinas;2023;2.785;2,4;1.371;1,2;1.414;1,2
3510302;Capela do Alto;2023;59;2,5;14;0,6;45;1,9
3510401;Capivari;2023;104;2,1;61;1,2;43;0,9
3510500;Caraguatatuba;2023;327;2,4;259;1,9;68;0,5
3510609;Carapicuíba;2023;270;0,7;220;0,6;50;0,1
3511102;Catanduva;2023;622;5,4;374;3,2;248;2,1
3512308;Conchas;2023;15;1,0;14;0,9;1;0,1
3512803;Cosmópolis;2023;61;1,0;28;0,5;33;0,6
3513009;Cotia;2023;518;1,9;133;0,5;385;1,4
3513405;Cruzeiro;2023;121;1,6;83;1,1;38;0,5
3513801;Diadema;2023;594;1,5;555;1,4;39;0,1
3514403;Dracena;2023;143;3,1;108;2,4;35;0,8
3515004;Embu;2023;244;1,0;89;0,4;155;0,6
3515186;Espírito Santo do Pinhal;2023;415;10,5;336;8,5;79;2,0
3515509;Fernandópolis;2023;135;1,9;84;1,2;51;0,7
3516200;Franca;2023;565;1,6;404;1,1;161;0,5
3516408;Franco da Rocha;2023;434;3,0;384;2,6;50;0,3
3516705;Garça;2023;269;6,4;240;5,7;29;0,7
3518206;Guararapes;2023;74;2,4;48;1,6;26;0,8
3518404;Guaratinguetá;2023;283;2,4;166;1,4;117;1,0
3518701;Guarujá;2023;447;1,6;306;1,1;141;0,5
3518800;Guarulhos;2023;1.901;1,5;1.423;1,1;478;0,4
3519071;Hortolândia;2023;106;0,4;84;0,4;22;0,1
3519600;Ibitinga;2023;104;1,7;49;0,8;55;0,9
3519709;Ibiúna;2023;245;3,2;70;0,9;175;2,3
3520442;Ilha Solteira;2023;110;4,3;74;2,9;36;1,4
3520509;Indaiatuba;2023;454;1,7;270;1,0;184;0,7
3520707;Indiaporã;2023;36;8,9;4;1,0;32;7,9
3521101;Ipeúna;2023;1;0,1;0;0,0;1;0,1
3522208;Itapecerica da Serra;2023;633;4,0;195;1,2;438;2,8
3522307;Itapetininga;2023;191;1,2;148;0,9;43;0,3
3522406;Itapeva;2023;147;1,6;102;1,1;45;0,5
3522505;Itapevi;2023;360;1,5;224;1,0;136;0,6
3522604;Itapira;2023;927;12,8;538;7,5;389;5,4
3522703;Itápolis;2023;69;1,8;43;1,1;26;0,7
3523206;Itararé;2023;78;1,8;51;1,2;27;0,6
3523404;Itatiba;2023;120;1,0;61;0,5;59;0,5
3523909;Itu;2023;465;2,8;351;2,1;114;0,7
3524006;Itupeva;2023;86;1,2;48;0,7;38;0,5
3524105;Ituverava;2023;120;3,2;53;1,4;67;1,8
3524303;Jaboticabal;2023;277;3,9;46;0,6;231;3,2
3524402;Jacareí;2023;354;1,5;165;0,7;189;0,8
3524501;Jaci;2023;216;27,9;168;21,7;48;6,2
3524808;Jales;2023;151;3,1;103;2,1;48;1,0
3525300;Jaú;2023;876;6,6;569;4,3;307;2,3
3525706;José Bonifácio;2023;67;1,8;37;1,0;30;0,8
3525904;Jundiaí;2023;876;2,0;464;1,0;412;0,9
3526704;Leme;2023;135;1,4;77;0,8;58;0,6
3526803;Lençóis Paulista;2023;171;2,6;44;0,7;127;1,9
3526902;Limeira;2023;386;1,3;172;0,6;214;0,7
3527108;Lins;2023;369;4,9;279;3,7;90;1,2
3527207;Lorena;2023;200;2,4;85;1,0;115;1,4
3529005;Marília;2023;855;3,6;572;2,4;283;1,2
3529302;Matão;2023;151;1,9;87;1,1;64;0,8
3529401;Mauá;2023;528;1,3;261;0,6;267;0,6
3530300;Mirassol;2023;79;1,2;28;0,4;51;0,8
3530508;Mococa;2023;137;2,0;78;1,2;59;0,9
3530607;Mogi das Cruzes;2023;848;1,9;591;1,3;257;0,6
3530706;Mogi-Guaçu;2023;347;2,2;155;1,0;192;1,2
3530805;Moji Mirim;2023;172;1,9;109;1,2;63;0,7
3531308;Monte Alto;2023;96;2,0;49;1,0;47;1,0
3532009;Morungaba;2023;9;0,6;8;0,6;1;0,1
3532603;Nhandeara;2023;129;13,2;35;3,6;94;9,6
3533007;Nova Granada;2023;62;3,2;19;1,0;43;2,2
3533502;Novo Horizonte;2023;73;1,9;41;1,1;32;0,8
3533908;Olímpia;2023;79;1,4;47;0,8;32;0,6
3534302;Orlândia;2023;98;2,6;60;1,6;38;1,0
3534401;Osasco;2023;949;1,3;629;0,9;320;0,4
3534609;Osvaldo Cruz;2023;72;2,3;58;1,9;14;0,4
3534708;Ourinhos;2023;167;1,6;97;0,9;70;0,7
3535309;Palmital;2023;43;2,2;29;1,5;14;0,7
3535507;Paraguaçu Paulista;2023;96;2,3;73;1,8;23;0,6
3538006;Pindamonhangaba;2023;255;1,5;129;0,8;126;0,8
3538600;Piracaia;2023;42;1,6;28;1,1;14;0,5
3538709;Piracicaba;2023;732;1,7;375;0,9;357;0,8
3538907;Pirajuí;2023;290;13,0;85;3,8;205;9,2
3539004;Pirangi;2023;47;4,3;22;2,0;25;2,3
3539301;Pirassununga;2023;127;1,7;67;0,9;60;0,8
3539509;Pitangueiras;2023;56;1,7;32;1,0;24;0,7
3540705;Porto Ferreira;2023;55;1,0;33;0,6;22;0,4
3541000;Praia Grande;2023;378;1,1;216;0,6;162;0,5
3541406;Presidente Prudente;2023;1.095;4,8;735;3,2;360;1,6
3541505;Presidente Venceslau;2023;102;2,9;62;1,8;40;1,1
3542206;Rancharia;2023;103;3,6;71;2,5;32;1,1
3542602;Registro;2023;242;4,0;195;3,2;47;0,8
3543303;Ribeirão Pires;2023;156;1,4;42;0,4;114;1,0
3543402;Ribeirão Preto;2023;2.242;3,2;1.425;2,0;817;1,2
3543907;Rio Claro;2023;387;1,9;210;1,0;177;0,9
3545803;Santa Bárbara d'Oeste;2023;196;1,1;116;0,6;80;0,4
3546405;Santa Cruz do Rio Pardo;2023;96;2,1;55;1,2;41;0,9
3546603;Santa Fé do Sul;2023;81;2,3;58;1,7;23;0,7
3547809;Santo André;2023;1.560;2,1;763;1,0;797;1,1
3548500;Santos;2023;1.627;3,9;720;1,7;907;2,2
3548609;São Bento do Sapucaí;2023;40;3,4;26;2,2;14;1,2
3548708;São Bernardo do Campo;2023;1.761;2,2;719;0,9;1.042;1,3
3548807;São Caetano do Sul;2023;795;4,8;177;1,1;618;3,7
3548906;São Carlos;2023;417;1,6;171;0,7;246;1,0
3549102;São João da Boa Vista;2023;199;2,1;94;1,0;105;1,1
3549409;São Joaquim da Barra;2023;104;2,1;63;1,3;41;0,8
3549706;São José do Rio Pardo;2023;141;2,7;79;1,5;62;1,2
3549805;São José do Rio Preto;2023;2.169;4,5;1.050;2,2;1.119;2,3
3549904;São José dos Campos;2023;1.590;2,3;735;1,0;855;1,2
3549953;São Lourenço da Serra;2023;60;3,7;0;0,0;60;3,7
3550100;São Manuel;2023;58;1,6;42;1,1;16;0,4
3550308;São Paulo;2023;30.293;2,7;15.409;1,3;14.884;1,3
3550605;São Roque;2023;274;3,5;62;0,8;212;2,7
3551009;São Vicente;2023;283;0,9;182;0,6;101;0,3
3551603;Serra Negra;2023;49;1,6;33;1,1;16;0,5
3551702;Sertãozinho;2023;134;1,0;61;0,5;73;0,6
3552205;Sorocaba;2023;1.627;2,2;904;1,2;723;1,0
3552502;Suzano;2023;352;1,1;191;0,6;161;0,5
3552809;Taboão da Serra;2023;450;1,6;289;1,1;161;0,6
3553609;Tapiratiba;2023;16;1,4;15;1,3;1;0,1
3553708;Taquaritinga;2023;122;2,3;74;1,4;48;0,9
3554003;Tatuí;2023;129;1,0;78;0,6;51;0,4
3554102;Taubaté;2023;516;1,7;366;1,2;150;0,5
3554508;Tietê;2023;55;1,5;33;0,9;22;0,6
3555000;Tupã;2023;340;5,3;324;5,1;16;0,3
3556206;Valinhos;2023;142;1,1;56;0,4;86;0,7
3556305;Valparaíso;2023;55;2,3;31;1,3;24;1,0
3556602;Vera Cruz;2023;72;7,1;0;0,0;72;7,1
3556701;Vinhedo;2023;85;1,1;62;0,8;23;0,3
3557006;Votorantim;2023;102;0,8;64;0,5;38;0,3
3557105;Votuporanga;2023;211;2,2;115;1,2;96;1,0
3500501;Águas de Lindóia;2023;42;2,3;30;1,7;12;0,7
3511003;Castilho;2023;31;1,5;30;1,5;1;0,0
3516002;Flórida Paulista;2023;47;3,6;30;2,3;17;1,3
3527405;Lucélia;2023;36;1,8;30;1,5;6;0,3
3531407;Monte Aprazível;2023;80;3,6;30;1,3;50;2,2
3553401;Tanabi;2023;72;2,8;30;1,2;42;1,7
3554409;Terra Roxa;2023;34;4,3;30;3,8;4;0,5
3555109;Tupi Paulista;2023;48;3,0;30;1,9;18;1,1
3556800;Viradouro;2023;48;2,8;30;1,7;18;1,0
3557204;Chavantes;2023;51;4,2;30;2,5;21;1,7
3500204;Adolfo;2022;0;0,0;0;0,0;0;0,0
3500402;Águas da Prata;2022;0;0,0;0;0,0;0;0,0
3500550;Águas de Santa Bárbara;2022;0;0,0;0;0,0;0;0,0
3500600;Águas de São Pedro;2022;0;0,0;0;0,0;0;0,0
3500758;Alambari;2022;0;0,0;0;0,0;0;0,0
3500808;Alfredo Marcondes;2022;0;0,0;0;0,0;0;0,0
3500907;Altair;2022;0;0,0;0;0,0;0;0,0
3501202;Álvares Florence;2022;0;0,0;0;0,0;0;0,0
3501400;Álvaro de Carvalho;2022;0;0,0;0;0,0;0;0,0
3501509;Alvinlândia;2022;0;0,0;0;0,0;0;0,0
3501806;Américo de Campos;2022;0;0,0;0;0,0;0;0,0
3502002;Analândia;2022;0;0,0;0;0,0;0;0,0
3502309;Anhembi;2022;0;0,0;0;0,0;0;0,0
3502408;Anhumas;2022;0;0,0;0;0,0;0;0,0
3502754;Araçariguama;2022;0;0,0;0;0,0;0;0,0
3503000;Aramina;2022;0;0,0;0;0,0;0;0,0
3503158;Arapeí;2022;0;0,0;0;0,0;0;0,0
3503356;Arco-Íris;2022;0;0,0;0;0,0;0;0,0
3503505;Areias;2022;0;0,0;0;0,0;0;0,0
3503604;Areiópolis;2022;0;0,0;0;0,0;0;0,0
3503703;Ariranha;2022;0;0,0;0;0,0;0;0,0
3503950;Aspásia;2022;0;0,0;0;0,0;0;0,0
3504305;Avaí;2022;0;0,0;0;0,0;0;0,0
3504404;Avanhandava;2022;0;0,0;0;0,0;0;0,0
3504602;Bady Bassitt;2022;0;0,0;0;0,0;0;0,0
3504701;Balbinos;2022;0;0,0;0;0,0;0;0,0
3504800;Bálsamo;2022;0;0,0;0;0,0;0;0,0
3505005;Barão de Antonina;2022;0;0,0;0;0,0;0;0,0
3505104;Barbosa;2022;0;0,0;0;0,0;0;0,0
3505351;Barra do Chapéu;2022;0;0,0;0;0,0;0;0,0
3505401;Barra do Turvo;2022;0;0,0;0;0,0;0;0,0
3505609;Barrinha;2022;0;0,0;0;0,0;0;0,0
3506201;Bento de Abreu;2022;0;0,0;0;0,0;0;0,0
3506904;Bofete;2022;0;0,0;0;0,0;0;0,0
3507159;Bom Sucesso de Itararé;2022;0;0,0;0;0,0;0;0,0
3507209;Borá;2022;0;0,0;0;0,0;0;0,0
3507308;Boracéia;2022;0;0,0;0;0,0;0;0,0
3507456;Borebi;2022;0;0,0;0;0,0;0;0,0
3507704;Braúna;2022;0;0,0;0;0,0;0;0,0
3507753;Brejo Alegre;2022;0;0,0;0;0,0;0;0,0
3507803;Brodowski;2022;0;0,0;0;0,0;0;0,0
3508009;Buri;2022;0;0,0;0;0,0;0;0,0
3508207;Buritizal;2022;0;0,0;0;0,0;0;0,0
3508306;Cabrália Paulista;2022;0;0,0;0;0,0;0;0,0
3508900;Caiabu;2022;0;0,0;0;0,0;0;0,0
3509106;Caiuá;2022;0;0,0;0;0,0;0;0,0
3509254;Cajati;2022;0;0,0;0;0,0;0;0,0
3509452;Campina do Monte Alegre;2022;0;0,0;0;0,0;0;0,0
3509809;Campos Novos Paulista;2022;0;0,0;0;0,0;0;0,0
3509908;Cananéia;2022;0;0,0;0;0,0;0;0,0
3509957;Canas;2022;0;0,0;0;0,0;0;0,0
3510104;Cândido Rodrigues;2022;0;0,0;0;0,0;0;0,0
3510153;Canitar;2022;0;0,0;0;0,0;0;0,0
3510906;Cássia dos Coqueiros;2022;0;0,0;0;0,0;0;0,0
3511201;Catiguá;2022;0;0,0;0;0,0;0;0,0
3511300;Cedral;2022;0;0,0;0;0,0;0;0,0
3512407;Cordeirópolis;2022;0;0,0;0;0,0;0;0,0
3512506;Coroados;2022;0;0,0;0;0,0;0;0,0
3512902;Cosmorama;2022;0;0,0;0;0,0;0;0,0
3513207;Cristais Paulista;2022;0;0,0;0;0,0;0;0,0
3513306;Cruzália;2022;0;0,0;0;0,0;0;0,0
3513850;Dirce Reis;2022;0;0,0;0;0,0;0;0,0
3514007;Dobrada;2022;0;0,0;0;0,0;0;0,0
3514205;Dolcinópolis;2022;0;0,0;0;0,0;0;0,0
3514601;Dumont;2022;0;0,0;0;0,0;0;0,0
3514700;Echaporã;2022;0;0,0;0;0,0;0;0,0
3514924;Elisiário;2022;0;0,0;0;0,0;0;0,0
3514957;Embaúba;2022;0;0,0;0;0,0;0;0,0
3515129;Emilianópolis;2022;0;0,0;0;0,0;0;0,0
3515152;Engenheiro Coelho;2022;0;0,0;0;0,0;0;0,0
3515194;Espírito Santo do Turvo;2022;0;0,0;0;0,0;0;0,0
3515301;Estrela do Norte;2022;0;0,0;0;0,0;0;0,0
3515350;Euclides da Cunha Paulista;2022;0;0,0;0;0,0;0;0,0
3515608;Fernando Prestes;2022;0;0,0;0;0,0;0;0,0
3515657;Fernão;2022;0;0,0;0;0,0;0;0,0
3515806;Flora Rica;2022;0;0,0;0;0,0;0;0,0
3515905;Floreal;2022;0;0,0;0;0,0;0;0,0
3516101;Florínea;2022;0;0,0;0;0,0;0;0,0
3516507;Gabriel Monteiro;2022;0;0,0;0;0,0;0;0,0
3516804;Gastão Vidigal;2022;0;0,0;0;0,0;0;0,0
3516853;Gavião Peixoto;2022;0;0,0;0;0,0;0;0,0
3517109;Glicério;2022;0;0,0;0;0,0;0;0,0
3517208;Guaiçara;2022;0;0,0;0;0,0;0;0,0
3517307;Guaimbê;2022;0;0,0;0;0,0;0;0,0
3517505;Guapiaçu;2022;0;0,0;0;0,0;0;0,0
3517604;Guapiara;2022;0;0,0;0;0,0;0;0,0
3517901;Guaraci;2022;0;0,0;0;0,0;0;0,0
3518008;Guarani d'Oeste;2022;0;0,0;0;0,0;0;0,0
3518107;Guarantã;2022;0;0,0;0;0,0;0;0,0
3518503;Guareí;2022;0;0,0;0;0,0;0;0,0
3518859;Guatapará;2022;0;0,0;0;0,0;0;0,0
3518909;Guzolândia;2022;0;0,0;0;0,0;0;0,0
3519055;Holambra;2022;0;0,0;0;0,0;0;0,0
3519204;Iacri;2022;0;0,0;0;0,0;0;0,0
3519253;Iaras;2022;0;0,0;0;0,0;0;0,0
3519501;Ibirarema;2022;0;0,0;0;0,0;0;0,0
3519808;Icém;2022;0;0,0;0;0,0;0;0,0
3520004;Igaraçu do Tietê;2022;0;0,0;0;0,0;0;0,0
3520426;Ilha Comprida;2022;0;0,0;0;0,0;0;0,0
3520608;Indiana;2022;0;0,0;0;0,0;0;0,0
3520806;Inúbia Paulista;2022;0;0,0;0;0,0;0;0,0
3521101;Ipeúna;2022;0;0,0;0;0,0;0;0,0
3521150;Ipiguá;2022;0;0,0;0;0,0;0;0,0
3521200;Iporanga;2022;0;0,0;0;0,0;0;0,0
3521507;Irapuã;2022;0;0,0;0;0,0;0;0,0
3521606;Irapuru;2022;0;0,0;0;0,0;0;0,0
3522000;Itaju;2022;0;0,0;0;0,0;0;0,0
3522158;Itaoca;2022;0;0,0;0;0,0;0;0,0
3522653;Itapirapuã Paulista;2022;0;0,0;0;0,0;0;0,0
3523008;Itapura;2022;0;0,0;0;0,0;0;0,0
3523305;Itariri;2022;0;0,0;0;0,0;0;0,0
3523701;Itirapuã;2022;0;0,0;0;0,0;0;0,0
3523800;Itobi;2022;0;0,0;0;0,0;0;0,0
3524600;Jacupiranga;2022;0;0,0;0;0,0;0;0,0
3524907;Jambeiro;2022;0;0,0;0;0,0;0;0,0
3525102;Jardinópolis;2022;0;0,0;0;0,0;0;0,0
3525409;Jeriquara;2022;0;0,0;0;0,0;0;0,0
3525607;João Ramalho;2022;0;0,0;0;0,0;0;0,0
3525805;Júlio Mesquita;2022;0;0,0;0;0,0;0;0,0
3525854;Jumirim;2022;0;0,0;0;0,0;0;0,0
3526100;Juquiá;2022;0;0,0;0;0,0;0;0,0
3526308;Lagoinha;2022;0;0,0;0;0,0;0;0,0
3526506;Lavínia;2022;0;0,0;0;0,0;0;0,0
3526605;Lavrinhas;2022;0;0,0;0;0,0;0;0,0
3527009;Lindóia;2022;0;0,0;0;0,0;0;0,0
3527256;Lourdes;2022;0;0,0;0;0,0;0;0,0
3527504;Lucianópolis;2022;0;0,0;0;0,0;0;0,0
3527603;Luís Antônio;2022;0;0,0;0;0,0;0;0,0
3527702;Luiziânia;2022;0;0,0;0;0,0;0;0,0
3527801;Lupércio;2022;0;0,0;0;0,0;0;0,0
3527900;Lutécia;2022;0;0,0;0;0,0;0;0,0
3528205;Macedônia;2022;0;0,0;0;0,0;0;0,0
3528304;Magda;2022;0;0,0;0;0,0;0;0,0
3528403;Mairinque;2022;0;0,0;0;0,0;0;0,0
3528601;Manduri;2022;0;0,0;0;0,0;0;0,0
3528700;Marabá Paulista;2022;0;0,0;0;0,0;0;0,0
3528858;Marapoama;2022;0;0,0;0;0,0;0;0,0
3528908;Mariápolis;2022;0;0,0;0;0,0;0;0,0
3529104;Marinópolis;2022;0;0,0;0;0,0;0;0,0
3529500;Mendonça;2022;0;0,0;0;0,0;0;0,0
3529609;Meridiano;2022;0;0,0;0;0,0;0;0,0
3529658;Mesópolis;2022;0;0,0;0;0,0;0;0,0
3529906;Miracatu;2022;0;0,0;0;0,0;0;0,0
3530003;Mira Estrela;2022;0;0,0;0;0,0;0;0,0
3530409;Mirassolândia;2022;0;0,0;0;0,0;0;0,0
3530904;Mombuca;2022;0;0,0;0;0,0;0;0,0
3531001;Monções;2022;0;0,0;0;0,0;0;0,0
3531209;Monte Alegre do Sul;2022;0;0,0;0;0,0;0;0,0
3531605;Monte Castelo;2022;0;0,0;0;0,0;0;0,0
3531704;Monteiro Lobato;2022;0;0,0;0;0,0;0;0,0
3532058;Motuca;2022;0;0,0;0;0,0;0;0,0
3532108;Murutinga do Sul;2022;0;0,0;0;0,0;0;0,0
3532157;Nantes;2022;0;0,0;0;0,0;0;0,0
3532207;Narandiba;2022;0;0,0;0;0,0;0;0,0
3532306;Natividade da Serra;2022;0;0,0;0;0,0;0;0,0
3532702;Nipoã;2022;0;0,0;0;0,0;0;0,0
3532801;Nova Aliança;2022;0;0,0;0;0,0;0;0,0
3532827;Nova Campina;2022;0;0,0;0;0,0;0;0,0
3532843;Nova Canaã Paulista;2022;0;0,0;0;0,0;0;0,0
3532868;Nova Castilho;2022;0;0,0;0;0,0;0;0,0
3533106;Nova Guataporanga;2022;0;0,0;0;0,0;0;0,0
3533205;Nova Independência;2022;0;0,0;0;0,0;0;0,0
3533254;Novais;2022;0;0,0;0;0,0;0;0,0
3533304;Nova Luzitânia;2022;0;0,0;0;0,0;0;0,0
3533601;Nuporanga;2022;0;0,0;0;0,0;0;0,0
3533700;Ocauçu;2022;0;0,0;0;0,0;0;0,0
3533809;Óleo;2022;0;0,0;0;0,0;0;0,0
3534005;Onda Verde;2022;0;0,0;0;0,0;0;0,0
3534104;Oriente;2022;0;0,0;0;0,0;0;0,0
3534203;Orindiúva;2022;0;0,0;0;0,0;0;0,0
3534500;Oscar Bressane;2022;0;0,0;0;0,0;0;0,0
3534807;Ouro Verde;2022;0;0,0;0;0,0;0;0,0
3535002;Palestina;2022;0;0,0;0;0,0;0;0,0
3535101;Palmares Paulista;2022;0;0,0;0;0,0;0;0,0
3535606;Paraibuna;2022;0;0,0;0;0,0;0;0,0
3535705;Paraíso;2022;0;0,0;0;0,0;0;0,0
3535903;Paranapuã;2022;0;0,0;0;0,0;0;0,0
3536109;Pardinho;2022;0;0,0;0;0,0;0;0,0
3536257;Parisi;2022;0;0,0;0;0,0;0;0,0
3536406;Paulicéia;2022;0;0,0;0;0,0;0;0,0
3536570;Paulistânia;2022;0;0,0;0;0,0;0;0,0
3536802;Pedra Bela;2022;0;0,0;0;0,0;0;0,0
3536901;Pedranópolis;2022;0;0,0;0;0,0;0;0,0
3537156;Pedrinhas Paulista;2022;0;0,0;0;0,0;0;0,0
3537503;Pereiras;2022;0;0,0;0;0,0;0;0,0
3537701;Piacatu;2022;0;0,0;0;0,0;0;0,0
3538105;Pindorama;2022;0;0,0;0;0,0;0;0,0
3538204;Pinhalzinho;2022;0;0,0;0;0,0;0;0,0
3538303;Piquerobi;2022;0;0,0;0;0,0;0;0,0
3538501;Piquete;2022;0;0,0;0;0,0;0;0,0
3539103;Pirapora do Bom Jesus;2022;0;0,0;0;0,0;0;0,0
3539202;Pirapozinho;2022;0;0,0;0;0,0;0;0,0
3539608;Planalto;2022;0;0,0;0;0,0;0;0,0
3539707;Platina;2022;0;0,0;0;0,0;0;0,0
3539905;Poloni;2022;0;0,0;0;0,0;0;0,0
3540101;Pongaí;2022;0;0,0;0;0,0;0;0,0
3540259;Pontalinda;2022;0;0,0;0;0,0;0;0,0
3540309;Pontes Gestal;2022;0;0,0;0;0,0;0;0,0
3540507;Porangaba;2022;0;0,0;0;0,0;0;0,0
3540754;Potim;2022;0;0,0;0;0,0;0;0,0
3540853;Pracinha;2022;0;0,0;0;0,0;0;0,0
3540903;Pradópolis;2022;0;0,0;0;0,0;0;0,0
3541059;Pratânia;2022;0;0,0;0;0,0;0;0,0
3541109;Presidente Alves;2022;0;0,0;0;0,0;0;0,0
3541653;Quadra;2022;0;0,0;0;0,0;0;0,0
3541703;Quatá;2022;0;0,0;0;0,0;0;0,0
3541802;Queiroz;2022;0;0,0;0;0,0;0;0,0
3542008;Quintana;2022;0;0,0;0;0,0;0;0,0
3542107;Rafard;2022;0;0,0;0;0,0;0;0,0
3542305;Redenção da Serra;2022;0;0,0;0;0,0;0;0,0
3542503;Reginópolis;2022;0;0,0;0;0,0;0;0,0
3542701;Restinga;2022;0;0,0;0;0,0;0;0,0
3542800;Ribeira;2022;0;0,0;0;0,0;0;0,0
3543105;Ribeirão Corrente;2022;0;0,0;0;0,0;0;0,0
3543204;Ribeirão do Sul;2022;0;0,0;0;0,0;0;0,0
3543238;Ribeirão dos Índios;2022;0;0,0;0;0,0;0;0,0
3543253;Ribeirão Grande;2022;0;0,0;0;0,0;0;0,0
3543501;Riversul;2022;0;0,0;0;0,0;0;0,0
3543600;Rifaina;2022;0;0,0;0;0,0;0;0,0
3543709;Rincão;2022;0;0,0;0;0,0;0;0,0
3544103;Rio Grande da Serra;2022;0;0,0;0;0,0;0;0,0
3544400;Rubiácea;2022;0;0,0;0;0,0;0;0,0
3544509;Rubinéia;2022;0;0,0;0;0,0;0;0,0
3544608;Sabino;2022;0;0,0;0;0,0;0;0,0
3544707;Sagres;2022;0;0,0;0;0,0;0;0,0
3544806;Sales;2022;0;0,0;0;0,0;0;0,0
3545100;Salmourão;2022;0;0,0;0;0,0;0;0,0
3545159;Saltinho;2022;0;0,0;0;0,0;0;0,0
3545506;Sandovalina;2022;0;0,0;0;0,0;0;0,0
3545704;Santa Albertina;2022;0;0,0;0;0,0;0;0,0
3546009;Santa Branca;2022;0;0,0;0;0,0;0;0,0
3546108;Santa Clara d'Oeste;2022;0;0,0;0;0,0;0;0,0
3546207;Santa Cruz da Conceição;2022;0;0,0;0;0,0;0;0,0
3546256;Santa Cruz da Esperança;2022;0;0,0;0;0,0;0;0,0
3546504;Santa Ernestina;2022;0;0,0;0;0,0;0;0,0
3546702;Santa Gertrudes;2022;0;0,0;0;0,0;0;0,0
3547106;Santa Mercedes;2022;0;0,0;0;0,0;0;0,0
3547205;Santana da Ponte Pensa;2022;0;0,0;0;0,0;0;0,0
3547403;Santa Rita d'Oeste;2022;0;0,0;0;0,0;0;0,0
3547650;Santa Salete;2022;0;0,0;0;0,0;0;0,0
3548005;Santo Antônio de Posse;2022;0;0,0;0;0,0;0;0,0
3548054;Santo Antônio do Aracanguá;2022;0;0,0;0;0,0;0;0,0
3548104;Santo Antônio do Jardim;2022;0;0,0;0;0,0;0;0,0
3548203;Santo Antônio do Pinhal;2022;0;0,0;0;0,0;0;0,0
3548302;Santo Expedito;2022;0;0,0;0;0,0;0;0,0
3548401;Santópolis do Aguapeí;2022;0;0,0;0;0,0;0;0,0
3549003;São Francisco;2022;0;0,0;0;0,0;0;0,0
3549201;São João das Duas Pontes;2022;0;0,0;0;0,0;0;0,0
3549250;São João de Iracema;2022;0;0,0;0;0,0;0;0,0
3549300;São João do Pau d'Alho;2022;0;0,0;0;0,0;0;0,0
3549508;São José da Bela Vista;2022;0;0,0;0;0,0;0;0,0
3549607;São José do Barreiro;2022;0;0,0;0;0,0;0;0,0
3550506;São Pedro do Turvo;2022;0;0,0;0;0,0;0;0,0
3551108;Sarapuí;2022;0;0,0;0;0,0;0;0,0
3551207;Sarutaiá;2022;0;0,0;0;0,0;0;0,0
3551306;Sebastianópolis do Sul;2022;0;0,0;0;0,0;0;0,0
3551405;Serra Azul;2022;0;0,0;0;0,0;0;0,0
3551801;Sete Barras;2022;0;0,0;0;0,0;0;0,0
3551900;Severínia;2022;0;0,0;0;0,0;0;0,0
3552551;Suzanápolis;2022;0;0,0;0;0,0;0;0,0
3552908;Taciba;2022;0;0,0;0;0,0;0;0,0
3553104;Taiaçu;2022;0;0,0;0;0,0;0;0,0
3553500;Tapiraí;2022;0;0,0;0;0,0;0;0,0
3553658;Taquaral;2022;0;0,0;0;0,0;0;0,0
3553856;Taquarivaí;2022;0;0,0;0;0,0;0;0,0
3553906;Tarabai;2022;0;0,0;0;0,0;0;0,0
3553955;Tarumã;2022;0;0,0;0;0,0;0;0,0
3554201;Tejupá;2022;0;0,0;0;0,0;0;0,0
3554607;Timburi;2022;0;0,0;0;0,0;0;0,0
3554656;Torre de Pedra;2022;0;0,0;0;0,0;0;0,0
3554755;Trabiju;2022;0;0,0;0;0,0;0;0,0
3554904;Três Fronteiras;2022;0;0,0;0;0,0;0;0,0
3554953;Tuiuti;2022;0;0,0;0;0,0;0;0,0
3555208;Turiúba;2022;0;0,0;0;0,0;0;0,0
3555307;Turmalina;2022;0;0,0;0;0,0;0;0,0
3555356;Ubarana;2022;0;0,0;0;0,0;0;0,0
3555505;Ubirajara;2022;0;0,0;0;0,0;0;0,0
3555604;Uchoa;2022;0;0,0;0;0,0;0;0,0
3555703;União Paulista;2022;0;0,0;0;0,0;0;0,0
3555901;Uru;2022;0;0,0;0;0,0;0;0,0
3556107;Valentim Gentil;2022;0;0,0;0;0,0;0;0,0
3556354;Vargem;2022;0;0,0;0;0,0;0;0,0
3556909;Vista Alegre do Alto;2022;0;0,0;0;0,0;0;0,0
3556958;Vitória Brasil;2022;0;0,0;0;0,0;0;0,0
3557154;Zacarias;2022;0;0,0;0;0,0;0;0,0
3557303;Estiva Gerbi;2022;0;0,0;0;0,0;0;0,0
3500303;Aguaí;2022;24;0,7;24;0,7;0;0,0
3501707;Américo Brasiliense;2022;261;6,3;261;6,3;0;0,0
3503109;Arandu;2022;6;1,0;6;1,0;0;0,0
3503802;Artur Nogueira;2022;8;0,1;8;0,1;0;0,0
3503901;Arujá;2022;39;0,4;39;0,4;0;0,0
3504909;Bananal;2022;15;1,4;15;1,4;0;0,0
3506300;Bernardino de Campos;2022;28;2,6;28;2,6;0;0,0
3506359;Bertioga;2022;49;0,7;49;0,7;0;0,0
3506607;Biritiba Mirim;2022;4;0,1;4;0,1;0;0,0
3506805;Bocaina;2022;18;1,5;18;1,5;0;0,0
3507100;Bom Jesus dos Perdões;2022;11;0,4;11;0,4;0;0,0
3508603;Cachoeira Paulista;2022;32;1,0;32;1,0;0;0,0
3508702;Caconde;2022;62;3,3;62;3,3;0;0,0
3509601;Campo Limpo Paulista;2022;54;0,6;54;0,6;0;0,0
3512100;Colômbia;2022;20;3,3;20;3,3;0;0,0
3512605;Coronel Macedo;2022;2;0,4;2;0,4;0;0,0
3512704;Corumbataí;2022;2;0,5;2;0,5;0;0,0
3513504;Cubatão;2022;84;0,6;84;0,6;0;0,0
3513900;Divinolândia;2022;186;17,2;186;17,2;0;0,0
3514304;Dourado;2022;17;2,0;17;2,0;0;0,0
3514809;Eldorado;2022;2;0,1;2;0,1;0;0,0
3514908;Elias Fausto;2022;6;0,3;6;0,3;0;0,0
3515103;Embu-Guaçu;2022;15;0,2;15;0,2;0;0,0
3515707;Ferraz de Vasconcelos;2022;189;1,0;189;1,0;0;0,0
3516309;Francisco Morato;2022;168;0,9;168;0,9;0;0,0
3519006;Herculândia;2022;58;6,2;58;6,2;0;0,0
3519907;Iepê;2022;18;2,3;18;2,3;0;0,0
3520202;Igaratá;2022;8;0,9;8;0,9;0;0,0
3520301;Iguape;2022;9;0,3;9;0,3;0;0,0
3520400;Ilhabela;2022;39;1,1;39;1,1;0;0,0
3521002;Iperó;2022;15;0,4;15;0,4;0;0,0
3521408;Iracemápolis;2022;3;0,1;3;0,1;0;0,0
3521705;Itaberá;2022;19;1,1;19;1,1;0;0,0
3522109;Itanhaém;2022;135;1,3;135;1,3;0;0,0
3522901;Itapuí;2022;30;2,1;30;2,1;0;0,0
3523602;Itirapina;2022;10;0,6;10;0,6;0;0,0
3524204;Jaborandi;2022;17;2,5;17;2,5;0;0,0
3524709;Jaguariúna;2022;84;1,5;84;1,5;0;0,0
3525508;Joanópolis;2022;11;0,9;11;0,9;0;0,0
3526209;Juquitiba;2022;1;0,0;1;0,0;0;0,0
3529807;Mineiros do Tietê;2022;11;0,9;11;0,9;0;0,0
3530102;Mirandópolis;2022;85;3,0;85;3,0;0;0,0
3530201;Mirante do Paranapanema;2022;23;1,3;23;1,3;0;0,0
3532405;Nazaré Paulista;2022;20;1,1;20;1,1;0;0,0
3533403;Nova Odessa;2022;35;0,6;35;0,6;0;0,0
3535408;Panorama;2022;31;2,0;31;2,0;0;0,0
3535804;Paranapanema;2022;15;0,7;15;0,7;0;0,0
3536208;Pariquera-Açu;2022;166;8,6;166;8,6;0;0,0
3536505;Paulínia;2022;118;1,1;118;1,1;0;0,0
3537107;Pedreira;2022;98;2,1;98;2,1;0;0,0
3537206;Pedro de Toledo;2022;3;0,3;3;0,3;0;0,0
3539806;Poá;2022;10;0,1;10;0,1;0;0,0
3541604;Promissão;2022;64;1,6;64;1,6;0;0,0
3541901;Queluz;2022;19;1,5;19;1,5;0;0,0
3543006;Ribeirão Branco;2022;26;1,5;26;1,5;0;0,0
3544251;Rosana;2022;80;4,4;80;4,4;0;0,0
3545001;Salesópolis;2022;9;0,5;9;0,5;0;0,0
3545209;Salto;2022;116;1,0;116;1,0;0;0,0
3547007;Santa Maria da Serra;2022;6;1,0;6;1,0;0;0,0
3547304;Santana de Parnaíba;2022;61;0,4;61;0,4;0;0,0
3547908;Santo Antônio da Alegria;2022;16;2,4;16;2,4;0;0,0
3550209;São Miguel Arcanjo;2022;65;2,0;65;2,0;0;0,0
3552007;Silveiras;2022;2;0,3;2;0,3;0;0,0
3553203;Taiúva;2022;4;0,6;4;0,6;0;0,0
3507407;Borborema;2022;26;1,7;16;1,0;10;0,6
3509700;Campos do Jordão;2022;195;3,9;185;3,7;10;0,2
3514502;Duartina;2022;87;7,3;77;6,5;10;0,8
3519303;Ibaté;2022;37;1,0;27;0,8;10;0,3
3532009;Morungaba;2022;19;1,4;9;0,7;10;0,7
3535200;Palmeira d'Oeste;2022;20;2,2;10;1,1;10;1,1
3541307;Presidente Epitácio;2022;78;1,8;68;1,6;10;0,2
3544905;Sales Oliveira;2022;30;2,6;20;1,7;10;0,9
3546306;Santa Cruz das Palmeiras;2022;35;1,0;25;0,7;10;0,3
3554805;Tremembé;2022;10;0,2;0;0,0;10;0,2
3505807;Bastos;2022;30;1,5;23;1,1;7;0,3
3511409;Cerqueira César;2022;39;2,0;32;1,6;7;0,4
3511706;Charqueada;2022;33;1,9;26;1,5;7;0,4
3518602;Guariba;2022;66;1,7;59;1,5;7;0,2
3521309;Ipuã;2022;50;3,1;43;2,7;7;0,4
3523503;Itatinga;2022;14;0,7;7;0,3;7;0,3
3540002;Pompéia;2022;26;1,2;19;0,9;7;0,3
3552106;Socorro;2022;70;1,8;63;1,6;7;0,2
3554706;Torrinha;2022;20;2,0;13;1,3;7;0,7
3507902;Brotas;2022;41;1,7;35;1,4;6;0,2
3515202;Estrela d'Oeste;2022;37;4,6;31;3,8;6;0,7
3520103;Igarapava;2022;43;1,4;37;1,2;6;0,2
3523107;Itaquaquecetuba;2022;256;0,7;250;0,7;6;0,0
3528502;Mairiporã;2022;47;0,5;41;0,4;6;0,1
3536000;Parapuã;2022;32;3,1;26;2,5;6;0,6
3542909;Ribeirão Bonito;2022;24;1,8;18;1,4;6;0,5
3554300;Teodoro Sampaio;2022;58;2,6;52;2,3;6;0,3
3510203;Capão Bonito;2022;45;1,0;37;0,8;8;0,2
3510807;Casa Branca;2022;406;13,7;398;13,4;8;0,3
3513702;Descalvado;2022;40;1,2;32;1,0;8;0,2
3515400;Fartura;2022;20;1,3;12;0,8;8;0,5
3517703;Guará;2022;60;2,9;52;2,5;8;0,4
3517802;Guaraçaí;2022;23;2,7;15;1,8;8;1,0
3537909;Pilar do Sul;2022;35;1,2;27;0,9;8;0,3
3544004;Rio das Pedras;2022;72;2,0;64;1,8;8;0,2
3545605;Santa Adélia;2022;19;1,3;11;0,7;8;0,5
3546900;Santa Lúcia;2022;8;0,9;0;0,0;8;0,9
3553302;Tambaú;2022;36;1,6;28;1,2;8;0,3
3510005;Cândido Mota;2022;30;1,0;25;0,8;5;0,2
3528106;Macaubal;2022;15;1,9;10;1,3;5;0,6
3529203;Martinópolis;2022;45;1,7;40;1,5;5;0,2
3532900;Nova Europa;2022;18;1,6;13;1,2;5;0,5
3534757;Ouroeste;2022;33;3,3;28;2,8;5;0,5
3534906;Pacaembu;2022;37;2,8;32;2,5;5;0,4
3537404;Pereira Barreto;2022;52;2,0;47;1,8;5;0,2
3553005;Taguaí;2022;29;2,1;24;1,8;5;0,4
3501004;Altinópolis;2022;31;2,0;29;1,9;2;0,1
3501301;Álvares Machado;2022;20;0,8;18;0,8;2;0,1
3513108;Cravinhos;2022;15;0,4;13;0,4;2;0,1
3517000;Getulina;2022;38;3,5;36;3,3;2;0,2
3518305;Guararema;2022;31;1,0;29;1,0;2;0,1
3519105;Iacanga;2022;30;2,6;28;2,4;2;0,2
3521804;Itaí;2022;35;1,3;33;1,2;2;0,1
3536703;Pederneiras;2022;62;1,3;60;1,3;2;0,0
3539400;Piratininga;2022;23;1,7;21;1,6;2;0,1
3552304;Sud Mennucci;2022;22;2,8;20;2,6;2;0,3
3555802;Urânia;2022;26;3,0;24;2,8;2;0,2
3556503;Várzea Paulista;2022;33;0,3;31;0,3;2;0,0
3531506;Monte Azul Paulista;2022;70;3,9;51;2,8;19;1,1
3538808;Piraju;2022;68;2,4;49;1,7;19;0,7
3547700;Santo Anastácio;2022;56;2,8;37;1,8;19;0,9
3552601;Tabapuã;2022;30;2,5;11;0,9;19;1,6
3556404;Vargem Grande do Sul;2022;50;1,2;31;0,7;19;0,5
3516606;Gália;2022;45;6,9;27;4,1;18;2,8
3517406;Guaíra;2022;71;1,8;53;1,4;18;0,5
3519402;Ibirá;2022;27;2,2;9;0,7;18;1,5
3526407;Laranjal Paulista;2022;46;1,6;28;1,0;18;0,6
3539509;Pitangueiras;2022;50;1,3;32;0,8;18;0,5
3540606;Porto Feliz;2022;63;1,2;45;0,9;18;0,3
3555406;Ubatuba;2022;92;1,0;74;0,8;18;0,2
3511508;Cerquilho;2022;38;0,8;26;0,5;12;0,3
3512209;Conchal;2022;52;1,9;40;1,4;12;0,4
3522802;Itaporanga;2022;41;2,8;29;2,0;12;0,8
3525201;Jarinu;2022;29;0,9;17;0,6;12;0,4
3531902;Morro Agudo;2022;47;1,4;35;1,1;12;0,4
3536307;Patrocínio Paulista;2022;35;2,4;23;1,6;12;0,8
3540408;Populina;2022;18;4,5;6;1,5;12;3,0
3545407;Salto Grande;2022;34;3,7;22;2,4;12;1,3
3546801;Santa Isabel;2022;86;1,5;74;1,3;12;0,2
3550407;São Pedro;2022;63;1,8;51;1,5;12;0,3
3550704;São Sebastião;2022;111;1,2;99;1,1;12;0,1
3502705;Apiaí;2022;55;2,2;51;2,1;4;0,2
3511607;Cesário Lange;2022;27;1,5;23;1,3;4;0,2
3527306;Louveira;2022;32;0,6;28;0,6;4;0,1
3528809;Maracaí;2022;26;1,9;22;1,6;4;0,3
3540200;Pontal;2022;25;0,5;21;0,4;4;0,1
3540804;Potirendaba;2022;32;1,9;28;1,7;4;0,2
3550803;São Sebastião da Grama;2022;30;2,5;26;2,2;4;0,3
3550902;São Simão;2022;40;2,7;36;2,4;4;0,3
3501103;Alto Alegre;2022;22;5,5;19;4,8;3;0,8
3502200;Angatuba;2022;57;2,3;54;2,2;3;0,1
3511904;Clementina;2022;24;2,8;21;2,5;3;0,4
3537602;Peruíbe;2022;18;0,3;15;0,2;3;0,0
3543808;Rinópolis;2022;23;2,4;20;2,1;3;0,3
3508801;Cafelândia;2022;48;2,8;37;2,1;11;0,6
3509304;Cajobi;2022;32;3,2;21;2,1;11;1,1
3520905;Ipaussu;2022;49;3,3;38;2,6;11;0,8
3532504;Neves Paulista;2022;21;2,5;10;1,2;11;1,3
3541208;Presidente Bernardes;2022;51;3,7;40;2,9;11;0,8
3544202;Riolândia;2022;36;3,1;25;2,2;11;1,0
3505203;Bariri;2022;58;1,7;45;1,3;13;0,4
3512001;Colina;2022;54;3,1;41;2,3;13;0,7
3528007;Macatuba;2022;31;1,8;18;1,1;13;0,8
3547601;Santa Rosa de Viterbo;2022;32;1,2;19;0,7;13;0,5
3551504;Serrana;2022;125;2,8;112;2,5;13;0,3
3552700;Tabatinga;2022;35;2,2;22;1,4;13;0,8
3510708;Cardoso;2022;31;2,6;10;0,9;21;1,8
3526001;Junqueirópolis;2022;46;2,3;25;1,2;21;1,0
3529708;Miguelópolis;2022;72;3,3;51;2,4;21;1,0
3504206;Auriflama;2022;44;3,0;35;2,4;9;0,6
3516903;General Salgado;2022;28;2,6;19;1,8;9;0,8
3531803;Monte Mor;2022;35;0,6;26;0,4;9;0,1
3537008;Pedregulho;2022;64;3,9;55;3,4;9;0,6
3542404;Regente Feijó;2022;40;2,0;31;1,6;9;0,5
3545308;Salto de Pirapora;2022;52;1,2;43;1,0;9;0,2
3550001;São Luiz do Paraitinga;2022;25;2,4;16;1,5;9;0,8
3552403;Sumaré;2022;201;0,7;192;0,7;9;0,0
3514106;Dois Córregos;2022;67;2,5;47;1,7;20;0,7
3537800;Piedade;2022;79;1,5;59;1,1;20;0,4
3507001;Boituva;2022;54;0,9;39;0,7;15;0,3
3513603;Cunha;2022;40;1,8;25;1,2;15;0,7
3521903;Itajobi;2022;50;3,4;35;2,4;15;1,0
3525003;Jandira;2022;15;0,1;0;0,0;15;0,1
3553807;Taquarituba;2022;47;2,0;32;1,4;15;0,6
3500105;Adamantina;2022;221;6,5;192;5,7;29;0,9
3500709;Agudos;2022;54;1,5;38;1,0;16;0,4
3501152;Alumínio;2022;120;6,6;0;0,0;120;6,6
3501608;Americana;2022;486;2,1;200;0,8;286;1,2
3501905;Amparo;2022;374;5,3;216;3,1;158;2,3
3502101;Andradina;2022;118;2,1;83;1,5;35;0,6
3502507;Aparecida;2022;92;2,6;69;1,9;23;0,6
3502606;Aparecida d'Oeste;2022;14;3,4;13;3,2;1;0,2
3502804;Araçatuba;2022;417;2,2;253;1,3;164;0,9
3502903;Araçoiaba da Serra;2022;330;9,9;45;1,4;285;8,6
3503208;Araraquara;2022;536;2,3;300;1,3;236;1,0
3503307;Araras;2022;448;3,4;205;1,5;243;1,8
3503406;Arealva;2022;32;3,9;15;1,8;17;2,1
3504008;Assis;2022;277;2,7;151;1,5;126;1,2
3504107;Atibaia;2022;192;1,4;55;0,4;137;1,0
3504503;Avaré;2022;172;2,0;126;1,4;46;0,5
3505302;Barra Bonita;2022;91;2,6;59;1,7;32;0,9
3505500;Barretos;2022;486;4,1;413;3,5;73;0,6
3505708;Barueri;2022;510;1,9;430;1,6;80;0,3
3505906;Batatais;2022;133;2,2;101;1,7;32;0,5
3506003;Bauru;2022;1.377;3,8;715;1,9;662;1,8
3506102;Bebedouro;2022;141;1,9;76;1,0;65;0,9
3506409;Bilac;2022;36;4,6;35;4,4;1;0,1
3506508;Birigui;2022;147;1,2;66;0,5;81;0,7
3506706;Boa Esperança do Sul;2022;16;1,1;15;1,0;1;0,1
3507506;Botucatu;2022;858;6,0;549;3,8;309;2,2
3507605;Bragança Paulista;2022;364;2,2;203;1,2;161;1,0
3508108;Buritama;2022;40;2,4;26;1,6;14;0,8
3508405;Cabreúva;2022;65;1,3;12;0,2;53;1,0
3508504;Caçapava;2022;199;2,2;75;0,8;124;1,3
3509007;Caieiras;2022;133;1,3;69;0,7;64;0,6
3509205;Cajamar;2022;139;1,7;39;0,5;100;1,3
3509403;Cajuru;2022;140;5,4;55;2,1;85;3,3
3509502;Campinas;2022;2.646;2,2;1.370;1,2;1.276;1,1
3510302;Capela do Alto;2022;59;2,8;14;0,7;45;2,1
3510401;Capivari;2022;104;1,9;61;1,1;43;0,8
3510500;Caraguatatuba;2022;322;2,7;254;2,2;68;0,6
3510609;Carapicuíba;2022;270;0,7;220;0,6;50;0,1
3511102;Catanduva;2022;592;5,0;374;3,2;218;1,9
3512308;Conchas;2022;15;0,9;14;0,8;1;0,1
3512803;Cosmópolis;2022;61;0,8;28;0,4;33;0,5
3513009;Cotia;2022;526;2,1;132;0,5;394;1,5
3513405;Cruzeiro;2022;121;1,5;83;1,0;38;0,5
3513801;Diadema;2022;632;1,6;593;1,5;39;0,1
3514403;Dracena;2022;150;3,3;115;2,5;35;0,8
3515004;Embu das Artes;2022;264;1,0;109;0,4;155;0,6
3515186;Espírito Santo do Pinhal;2022;422;9,9;343;8,0;79;1,8
3515509;Fernandópolis;2022;135;2,0;84;1,3;51;0,8
3516200;Franca;2022;535;1,5;370;1,1;165;0,5
3516408;Franco da Rocha;2022;434;2,8;384;2,5;50;0,3
3516705;Garça;2022;269;6,4;240;5,7;29;0,7
3518206;Guararapes;2022;74;2,3;48;1,5;26;0,8
3518404;Guaratinguetá;2022;310;2,6;183;1,5;127;1,1
3518701;Guarujá;2022;447;1,4;306;1,0;141;0,4
3518800;Guarulhos;2022;1.890;1,4;1.423;1,0;467;0,3
3519071;Hortolândia;2022;119;0,5;97;0,4;22;0,1
3519600;Ibitinga;2022;104;1,8;49;0,8;55;0,9
3519709;Ibiúna;2022;228;2,9;70;0,9;158;2,0
3520442;Ilha Solteira;2022;110;4,3;74;2,9;36;1,4
3520509;Indaiatuba;2022;384;1,5;228;0,9;156;0,6
3520707;Indiaporã;2022;36;9,4;4;1,0;32;8,3
3522208;Itapecerica da Serra;2022;650;3,8;195;1,1;455;2,6
3522307;Itapetininga;2022;152;0,9;110;0,7;42;0,3
3522406;Itapeva;2022;147;1,6;102;1,1;45;0,5
3522505;Itapevi;2022;360;1,5;224;0,9;136;0,6
3522604;Itapira;2022;939;13,1;560;7,8;379;5,3
3522703;Itápolis;2022;69;1,7;43;1,0;26;0,6
3523206;Itararé;2022;78;1,6;51;1,0;27;0,5
3523404;Itatiba;2022;120;1,0;61;0,5;59;0,5
3523909;Itu;2022;436;2,5;351;2,0;85;0,5
3524006;Itupeva;2022;86;1,4;48;0,8;38;0,6
3524105;Ituverava;2022;120;3,0;53;1,3;67;1,7
3524303;Jaboticabal;2022;277;3,7;46;0,6;231;3,1
3524402;Jacareí;2022;363;1,6;167;0,7;196;0,9
3524501;Jaci;2022;216;30,3;149;20,9;67;9,4
3524808;Jales;2022;151;3,2;103;2,2;48;1,0
3525300;Jaú;2022;996;6,7;679;4,5;317;2,1
3525706;José Bonifácio;2022;67;1,8;22;0,6;45;1,2
3525904;Jundiaí;2022;841;2,0;426;1,0;415;1,0
3526704;Leme;2022;135;1,3;77;0,8;58;0,6
3526803;Lençóis Paulista;2022;171;2,6;44;0,7;127;1,9
3526902;Limeira;2022;390;1,3;172;0,6;218;0,7
3527108;Lins;2022;417;5,5;333;4,4;84;1,1
3527207;Lorena;2022;173;2,0;85;1,0;88;1,0
3529005;Marília;2022;892;3,8;687;2,9;205;0,9
3529302;Matão;2022;152;1,9;93;1,2;59;0,7
3529401;Mauá;2022;496;1,1;229;0,5;267;0,6
3530300;Mirassol;2022;79;1,4;28;0,5;51;0,9
3530508;Mococa;2022;137;2,1;78;1,2;59;0,9
3530607;Mogi das Cruzes;2022;852;1,9;598;1,4;254;0,6
3530706;Mogi Guaçu;2022;347;2,3;155;1,0;192;1,3
3530805;Mogi Mirim;2022;173;1,9;109;1,2;64;0,7
3531100;Mongaguá;2022;90;1,6;36;0,6;54;1,0
3531308;Monte Alto;2022;94;1,9;48;1,0;46;0,9
3532603;Nhandeara;2022;129;12,0;35;3,3;94;8,8
3533007;Nova Granada;2022;62;2,9;19;0,9;43;2,0
3533502;Novo Horizonte;2022;83;2,1;47;1,2;36;0,9
3533908;Olímpia;2022;79;1,5;41;0,8;38;0,7
3534302;Orlândia;2022;98;2,3;60;1,4;38;0,9
3534401;Osasco;2022;980;1,4;682;1,0;298;0,4
3534609;Osvaldo Cruz;2022;72;2,3;58;1,9;14;0,4
3534708;Ourinhos;2022;169;1,5;97;0,9;72;0,6
3535309;Palmital;2022;43;2,0;27;1,2;16;0,7
3535507;Paraguaçu Paulista;2022;96;2,2;73;1,6;23;0,5
3536604;Paulo de Faria;2022;11;1,3;10;1,2;1;0,1
3537305;Penápolis;2022;180;2,9;157;2,6;23;0,4
3538006;Pindamonhangaba;2022;255;1,5;129;0,8;126;0,8
3538600;Piracaia;2022;42;1,6;28;1,1;14;0,5
3538709;Piracicaba;2022;760;1,9;405;1,0;355;0,9
3538907;Pirajuí;2022;290;12,5;85;3,6;205;8,8
3539004;Pirangi;2022;45;4,2;20;1,8;25;2,3
3539301;Pirassununga;2022;178;2,4;66;0,9;112;1,5
3540705;Porto Ferreira;2022;55;1,0;33;0,6;22;0,4
3541000;Praia Grande;2022;339;1,0;207;0,6;132;0,4
3541406;Presidente Prudente;2022;1.095;4,9;735;3,3;360;1,6
3541505;Presidente Venceslau;2022;102;2,7;62;1,6;40;1,1
3542206;Rancharia;2022;103;3,6;71;2,5;32;1,1
3542602;Registro;2022;237;4,4;192;3,5;45;0,8
3543303;Ribeirão Pires;2022;164;1,4;50;0,4;114;1,0
3543402;Ribeirão Preto;2022;2.265;3,3;1.422;2,0;843;1,2
3543907;Rio Claro;2022;369;1,8;218;1,1;151;0,7
3544301;Roseira;2022;54;5,0;14;1,3;40;3,7
3545803;Santa Bárbara d'Oeste;2022;196;1,0;116;0,6;80;0,4
3546405;Santa Cruz do Rio Pardo;2022;96;2,1;55;1,2;41;0,9
3546603;Santa Fé do Sul;2022;80;2,6;63;2,0;17;0,5
3547502;Santa Rita do Passa Quatro;2022;311;11,8;288;10,9;23;0,9
3547809;Santo André;2022;1.575;2,3;742;1,1;833;1,2
3548500;Santos;2022;1.609;3,7;720;1,7;889;2,1
3548609;São Bento do Sapucaí;2022;40;3,8;26;2,5;14;1,3
3548708;São Bernardo do Campo;2022;1.743;2,1;719;0,9;1.024;1,3
3548807;São Caetano do Sul;2022;795;5,3;177;1,2;618;4,1
3548906;São Carlos;2022;409;1,7;167;0,7;242;1,0
3549102;São João da Boa Vista;2022;199;2,3;94;1,1;105;1,2
3549409;São Joaquim da Barra;2022;104;2,0;63;1,2;41;0,8
3549706;São José do Rio Pardo;2022;141;2,6;80;1,5;61;1,1
3549805;São José do Rio Preto;2022;2.148;4,7;1.070;2,4;1.078;2,4
3549904;São José dos Campos;2022;1.588;2,2;730;1,0;858;1,2
3549953;São Lourenço da Serra;2022;60;3,8;0;0,0;60;3,8
3550100;São Manuel;2022;58;1,5;42;1,1;16;0,4
3550308;São Paulo;2022;29.764;2,5;15.418;1,3;14.346;1,2
3550605;São Roque;2022;275;3,1;62;0,7;213;2,4
3551009;São Vicente;2022;276;0,8;176;0,5;100;0,3
3551603;Serra Negra;2022;49;1,8;33;1,2;16;0,6
3551702;Sertãozinho;2022;131;1,1;61;0,5;70;0,6
3552205;Sorocaba;2022;1.421;2,1;875;1,3;546;0,8
3552502;Suzano;2022;272;0,9;111;0,4;161;0,5
3552809;Taboão da Serra;2022;450;1,5;289;1,0;161;0,6
3553609;Tapiratiba;2022;16;1,3;15;1,2;1;0,1
3553708;Taquaritinga;2022;122;2,2;74;1,4;48;0,9
3554003;Tatuí;2022;105;0,9;59;0,5;46;0,4
3554102;Taubaté;2022;516;1,7;366;1,2;150;0,5
3554508;Tietê;2022;55;1,3;33;0,8;22;0,5
3555000;Tupã;2022;340;5,4;324;5,2;16;0,3
3556008;Urupês;2022;34;2,6;11;0,8;23;1,7
3556206;Valinhos;2022;142;1,1;56;0,4;86;0,7
3556305;Valparaíso;2022;55;2,3;31;1,3;24;1,0
3556453;Vargem Grande Paulista;2022;40;0,7;0;0,0;40;0,7
3556602;Vera Cruz;2022;72;6,9;0;0,0;72;6,9
3556701;Vinhedo;2022;85;1,1;62;0,8;23;0,3
3557006;Votorantim;2022;102;0,8;64;0,5;38;0,3
3557105;Votuporanga;2022;219;2,4;115;1,2;104;1,1
3500501;Águas de Lindóia;2022;42;2,3;30;1,6;12;0,6
3511003;Castilho;2022;31;1,5;30;1,4;1;0,0
3516002;Flórida Paulista;2022;47;3,9;30;2,5;17;1,4
3527405;Lucélia;2022;36;1,7;30;1,4;6;0,3
3531407;Monte Aprazível;2022;80;3,4;30;1,3;50;2,1
3553401;Tanabi;2022;72;2,9;30;1,2;42;1,7
3554409;Terra Roxa;2022;34;3,7;30;3,3;4;0,4
3555109;Tupi Paulista;2022;48;3,2;30;2,0;18;1,2
3556800;Viradouro;2022;48;2,6;30;1,6;18;1,0
3557204;Chavantes;2022;51;4,2;30;2,5;21;1,7
3500204;Adolfo;2021;0;0,0;0;0,0;0;0,0
3500303;Aguaí;2021;0;0,0;0;0,0;0;0,0
3500402;Águas da Prata;2021;0;0,0;0;0,0;0;0,0
3500550;Águas de Santa Bárbara;2021;0;0,0;0;0,0;0;0,0
3500600;Águas de São Pedro;2021;0;0,0;0;0,0;0;0,0
3500758;Alambari;2021;0;0,0;0;0,0;0;0,0
3500808;Alfredo Marcondes;2021;0;0,0;0;0,0;0;0,0
3500907;Altair;2021;0;0,0;0;0,0;0;0,0
3501202;Álvares Florence;2021;0;0,0;0;0,0;0;0,0
3501400;Álvaro de Carvalho;2021;0;0,0;0;0,0;0;0,0
3501509;Alvinlândia;2021;0;0,0;0;0,0;0;0,0
3501806;Américo de Campos;2021;0;0,0;0;0,0;0;0,0
3502002;Analândia;2021;0;0,0;0;0,0;0;0,0
3502309;Anhembi;2021;0;0,0;0;0,0;0;0,0
3502408;Anhumas;2021;0;0,0;0;0,0;0;0,0
3502754;Araçariguama;2021;0;0,0;0;0,0;0;0,0
3503000;Aramina;2021;0;0,0;0;0,0;0;0,0
3503158;Arapeí;2021;0;0,0;0;0,0;0;0,0
3503356;Arco-Íris;2021;0;0,0;0;0,0;0;0,0
3503505;Areias;2021;0;0,0;0;0,0;0;0,0
3503604;Areiópolis;2021;0;0,0;0;0,0;0;0,0
3503703;Ariranha;2021;0;0,0;0;0,0;0;0,0
3503950;Aspásia;2021;0;0,0;0;0,0;0;0,0
3504305;Avaí;2021;0;0,0;0;0,0;0;0,0
3504404;Avanhandava;2021;0;0,0;0;0,0;0;0,0
3504602;Bady Bassitt;2021;0;0,0;0;0,0;0;0,0
3504701;Balbinos;2021;0;0,0;0;0,0;0;0,0
3504800;Bálsamo;2021;0;0,0;0;0,0;0;0,0
3505005;Barão de Antonina;2021;0;0,0;0;0,0;0;0,0
3505104;Barbosa;2021;0;0,0;0;0,0;0;0,0
3505351;Barra do Chapéu;2021;0;0,0;0;0,0;0;0,0
3505401;Barra do Turvo;2021;0;0,0;0;0,0;0;0,0
3505609;Barrinha;2021;0;0,0;0;0,0;0;0,0
3506201;Bento de Abreu;2021;0;0,0;0;0,0;0;0,0
3506904;Bofete;2021;0;0,0;0;0,0;0;0,0
3507159;Bom Sucesso de Itararé;2021;0;0,0;0;0,0;0;0,0
3507209;Borá;2021;0;0,0;0;0,0;0;0,0
3507308;Boracéia;2021;0;0,0;0;0,0;0;0,0
3507456;Borebi;2021;0;0,0;0;0,0;0;0,0
3507704;Braúna;2021;0;0,0;0;0,0;0;0,0
3507753;Brejo Alegre;2021;0;0,0;0;0,0;0;0,0
3507803;Brodowski;2021;0;0,0;0;0,0;0;0,0
3508009;Buri;2021;0;0,0;0;0,0;0;0,0
3508207;Buritizal;2021;0;0,0;0;0,0;0;0,0
3508306;Cabrália Paulista;2021;0;0,0;0;0,0;0;0,0
3508900;Caiabu;2021;0;0,0;0;0,0;0;0,0
3509106;Caiuá;2021;0;0,0;0;0,0;0;0,0
3509254;Cajati;2021;0;0,0;0;0,0;0;0,0
3509452;Campina do Monte Alegre;2021;0;0,0;0;0,0;0;0,0
3509809;Campos Novos Paulista;2021;0;0,0;0;0,0;0;0,0
3509908;Cananéia;2021;0;0,0;0;0,0;0;0,0
3509957;Canas;2021;0;0,0;0;0,0;0;0,0
3510104;Cândido Rodrigues;2021;0;0,0;0;0,0;0;0,0
3510153;Canitar;2021;0;0,0;0;0,0;0;0,0
3510906;Cássia dos Coqueiros;2021;0;0,0;0;0,0;0;0,0
3511201;Catiguá;2021;0;0,0;0;0,0;0;0,0
3512407;Cordeirópolis;2021;0;0,0;0;0,0;0;0,0
3512506;Coroados;2021;0;0,0;0;0,0;0;0,0
3512902;Cosmorama;2021;0;0,0;0;0,0;0;0,0
3513207;Cristais Paulista;2021;0;0,0;0;0,0;0;0,0
3513306;Cruzália;2021;0;0,0;0;0,0;0;0,0
3513850;Dirce Reis;2021;0;0,0;0;0,0;0;0,0
3514007;Dobrada;2021;0;0,0;0;0,0;0;0,0
3514205;Dolcinópolis;2021;0;0,0;0;0,0;0;0,0
3514601;Dumont;2021;0;0,0;0;0,0;0;0,0
3514700;Echaporã;2021;0;0,0;0;0,0;0;0,0
3514924;Elisiário;2021;0;0,0;0;0,0;0;0,0
3514957;Embaúba;2021;0;0,0;0;0,0;0;0,0
3515129;Emilianópolis;2021;0;0,0;0;0,0;0;0,0
3515152;Engenheiro Coelho;2021;0;0,0;0;0,0;0;0,0
3515194;Espírito Santo do Turvo;2021;0;0,0;0;0,0;0;0,0
3515301;Estrela do Norte;2021;0;0,0;0;0,0;0;0,0
3515350;Euclides da Cunha Paulista;2021;0;0,0;0;0,0;0;0,0
3515608;Fernando Prestes;2021;0;0,0;0;0,0;0;0,0
3515657;Fernão;2021;0;0,0;0;0,0;0;0,0
3515806;Flora Rica;2021;0;0,0;0;0,0;0;0,0
3515905;Floreal;2021;0;0,0;0;0,0;0;0,0
3516101;Florínea;2021;0;0,0;0;0,0;0;0,0
3516507;Gabriel Monteiro;2021;0;0,0;0;0,0;0;0,0
3516804;Gastão Vidigal;2021;0;0,0;0;0,0;0;0,0
3516853;Gavião Peixoto;2021;0;0,0;0;0,0;0;0,0
3517109;Glicério;2021;0;0,0;0;0,0;0;0,0
3517208;Guaiçara;2021;0;0,0;0;0,0;0;0,0
3517307;Guaimbê;2021;0;0,0;0;0,0;0;0,0
3517505;Guapiaçu;2021;0;0,0;0;0,0;0;0,0
3517901;Guaraci;2021;0;0,0;0;0,0;0;0,0
3518008;Guarani d'Oeste;2021;0;0,0;0;0,0;0;0,0
3518107;Guarantã;2021;0;0,0;0;0,0;0;0,0
3518503;Guareí;2021;0;0,0;0;0,0;0;0,0
3518859;Guatapará;2021;0;0,0;0;0,0;0;0,0
3518909;Guzolândia;2021;0;0,0;0;0,0;0;0,0
3519055;Holambra;2021;0;0,0;0;0,0;0;0,0
3519204;Iacri;2021;0;0,0;0;0,0;0;0,0
3519253;Iaras;2021;0;0,0;0;0,0;0;0,0
3519501;Ibirarema;2021;0;0,0;0;0,0;0;0,0
3519808;Icém;2021;0;0,0;0;0,0;0;0,0
3520004;Igaraçu do Tietê;2021;0;0,0;0;0,0;0;0,0
3520426;Ilha Comprida;2021;0;0,0;0;0,0;0;0,0
3520608;Indiana;2021;0;0,0;0;0,0;0;0,0
3520806;Inúbia Paulista;2021;0;0,0;0;0,0;0;0,0
3521101;Ipeúna;2021;0;0,0;0;0,0;0;0,0
3521150;Ipiguá;2021;0;0,0;0;0,0;0;0,0
3521200;Iporanga;2021;0;0,0;0;0,0;0;0,0
3521507;Irapuã;2021;0;0,0;0;0,0;0;0,0
3521606;Irapuru;2021;0;0,0;0;0,0;0;0,0
3522000;Itaju;2021;0;0,0;0;0,0;0;0,0
3522158;Itaoca;2021;0;0,0;0;0,0;0;0,0
3522653;Itapirapuã Paulista;2021;0;0,0;0;0,0;0;0,0
3523008;Itapura;2021;0;0,0;0;0,0;0;0,0
3523305;Itariri;2021;0;0,0;0;0,0;0;0,0
3523701;Itirapuã;2021;0;0,0;0;0,0;0;0,0
3523800;Itobi;2021;0;0,0;0;0,0;0;0,0
3524600;Jacupiranga;2021;0;0,0;0;0,0;0;0,0
3524907;Jambeiro;2021;0;0,0;0;0,0;0;0,0
3525102;Jardinópolis;2021;0;0,0;0;0,0;0;0,0
3525409;Jeriquara;2021;0;0,0;0;0,0;0;0,0
3525607;João Ramalho;2021;0;0,0;0;0,0;0;0,0
3525805;Júlio Mesquita;2021;0;0,0;0;0,0;0;0,0
3525854;Jumirim;2021;0;0,0;0;0,0;0;0,0
3526100;Juquiá;2021;0;0,0;0;0,0;0;0,0
3526308;Lagoinha;2021;0;0,0;0;0,0;0;0,0
3526506;Lavínia;2021;0;0,0;0;0,0;0;0,0
3526605;Lavrinhas;2021;0;0,0;0;0,0;0;0,0
3527009;Lindóia;2021;0;0,0;0;0,0;0;0,0
3527256;Lourdes;2021;0;0,0;0;0,0;0;0,0
3527504;Lucianópolis;2021;0;0,0;0;0,0;0;0,0
3527603;Luís Antônio;2021;0;0,0;0;0,0;0;0,0
3527702;Luiziânia;2021;0;0,0;0;0,0;0;0,0
3527801;Lupércio;2021;0;0,0;0;0,0;0;0,0
3527900;Lutécia;2021;0;0,0;0;0,0;0;0,0
3528205;Macedônia;2021;0;0,0;0;0,0;0;0,0
3528304;Magda;2021;0;0,0;0;0,0;0;0,0
3528403;Mairinque;2021;0;0,0;0;0,0;0;0,0
3528601;Manduri;2021;0;0,0;0;0,0;0;0,0
3528700;Marabá Paulista;2021;0;0,0;0;0,0;0;0,0
3528858;Marapoama;2021;0;0,0;0;0,0;0;0,0
3528908;Mariápolis;2021;0;0,0;0;0,0;0;0,0
3529104;Marinópolis;2021;0;0,0;0;0,0;0;0,0
3529500;Mendonça;2021;0;0,0;0;0,0;0;0,0
3529609;Meridiano;2021;0;0,0;0;0,0;0;0,0
3529658;Mesópolis;2021;0;0,0;0;0,0;0;0,0
3529906;Miracatu;2021;0;0,0;0;0,0;0;0,0
3530003;Mira Estrela;2021;0;0,0;0;0,0;0;0,0
3530409;Mirassolândia;2021;0;0,0;0;0,0;0;0,0
3530904;Mombuca;2021;0;0,0;0;0,0;0;0,0
3531001;Monções;2021;0;0,0;0;0,0;0;0,0
3531209;Monte Alegre do Sul;2021;0;0,0;0;0,0;0;0,0
3531605;Monte Castelo;2021;0;0,0;0;0,0;0;0,0
3531704;Monteiro Lobato;2021;0;0,0;0;0,0;0;0,0
3532058;Motuca;2021;0;0,0;0;0,0;0;0,0
3532108;Murutinga do Sul;2021;0;0,0;0;0,0;0;0,0
3532157;Nantes;2021;0;0,0;0;0,0;0;0,0
3532207;Narandiba;2021;0;0,0;0;0,0;0;0,0
3532306;Natividade da Serra;2021;0;0,0;0;0,0;0;0,0
3532702;Nipoã;2021;0;0,0;0;0,0;0;0,0
3532801;Nova Aliança;2021;0;0,0;0;0,0;0;0,0
3532827;Nova Campina;2021;0;0,0;0;0,0;0;0,0
3532843;Nova Canaã Paulista;2021;0;0,0;0;0,0;0;0,0
3532868;Nova Castilho;2021;0;0,0;0;0,0;0;0,0
3533106;Nova Guataporanga;2021;0;0,0;0;0,0;0;0,0
3533205;Nova Independência;2021;0;0,0;0;0,0;0;0,0
3533254;Novais;2021;0;0,0;0;0,0;0;0,0
3533304;Nova Luzitânia;2021;0;0,0;0;0,0;0;0,0
3533601;Nuporanga;2021;0;0,0;0;0,0;0;0,0
3533700;Ocauçu;2021;0;0,0;0;0,0;0;0,0
3533809;Óleo;2021;0;0,0;0;0,0;0;0,0
3534005;Onda Verde;2021;0;0,0;0;0,0;0;0,0
3534104;Oriente;2021;0;0,0;0;0,0;0;0,0
3534203;Orindiúva;2021;0;0,0;0;0,0;0;0,0
3534500;Oscar Bressane;2021;0;0,0;0;0,0;0;0,0
3534807;Ouro Verde;2021;0;0,0;0;0,0;0;0,0
3535002;Palestina;2021;0;0,0;0;0,0;0;0,0
3535101;Palmares Paulista;2021;0;0,0;0;0,0;0;0,0
3535606;Paraibuna;2021;0;0,0;0;0,0;0;0,0
3535705;Paraíso;2021;0;0,0;0;0,0;0;0,0
3535903;Paranapuã;2021;0;0,0;0;0,0;0;0,0
3536109;Pardinho;2021;0;0,0;0;0,0;0;0,0
3536257;Parisi;2021;0;0,0;0;0,0;0;0,0
3536406;Paulicéia;2021;0;0,0;0;0,0;0;0,0
3536570;Paulistânia;2021;0;0,0;0;0,0;0;0,0
3536802;Pedra Bela;2021;0;0,0;0;0,0;0;0,0
3536901;Pedranópolis;2021;0;0,0;0;0,0;0;0,0
3537156;Pedrinhas Paulista;2021;0;0,0;0;0,0;0;0,0
3537503;Pereiras;2021;0;0,0;0;0,0;0;0,0
3537701;Piacatu;2021;0;0,0;0;0,0;0;0,0
3538105;Pindorama;2021;0;0,0;0;0,0;0;0,0
3538204;Pinhalzinho;2021;0;0,0;0;0,0;0;0,0
3538303;Piquerobi;2021;0;0,0;0;0,0;0;0,0
3538501;Piquete;2021;0;0,0;0;0,0;0;0,0
3539103;Pirapora do Bom Jesus;2021;0;0,0;0;0,0;0;0,0
3539202;Pirapozinho;2021;0;0,0;0;0,0;0;0,0
3539608;Planalto;2021;0;0,0;0;0,0;0;0,0
3539707;Platina;2021;0;0,0;0;0,0;0;0,0
3539905;Poloni;2021;0;0,0;0;0,0;0;0,0
3540101;Pongaí;2021;0;0,0;0;0,0;0;0,0
3540259;Pontalinda;2021;0;0,0;0;0,0;0;0,0
3540309;Pontes Gestal;2021;0;0,0;0;0,0;0;0,0
3540507;Porangaba;2021;0;0,0;0;0,0;0;0,0
3540754;Potim;2021;0;0,0;0;0,0;0;0,0
3540853;Pracinha;2021;0;0,0;0;0,0;0;0,0
3540903;Pradópolis;2021;0;0,0;0;0,0;0;0,0
3541059;Pratânia;2021;0;0,0;0;0,0;0;0,0
3541109;Presidente Alves;2021;0;0,0;0;0,0;0;0,0
3541653;Quadra;2021;0;0,0;0;0,0;0;0,0
3541703;Quatá;2021;0;0,0;0;0,0;0;0,0
3541802;Queiroz;2021;0;0,0;0;0,0;0;0,0
3542008;Quintana;2021;0;0,0;0;0,0;0;0,0
3542107;Rafard;2021;0;0,0;0;0,0;0;0,0
3542305;Redenção da Serra;2021;0;0,0;0;0,0;0;0,0
3542503;Reginópolis;2021;0;0,0;0;0,0;0;0,0
3542701;Restinga;2021;0;0,0;0;0,0;0;0,0
3542800;Ribeira;2021;0;0,0;0;0,0;0;0,0
3543105;Ribeirão Corrente;2021;0;0,0;0;0,0;0;0,0
3543204;Ribeirão do Sul;2021;0;0,0;0;0,0;0;0,0
3543238;Ribeirão dos Índios;2021;0;0,0;0;0,0;0;0,0
3543253;Ribeirão Grande;2021;0;0,0;0;0,0;0;0,0
3543501;Riversul;2021;0;0,0;0;0,0;0;0,0
3543600;Rifaina;2021;0;0,0;0;0,0;0;0,0
3543709;Rincão;2021;0;0,0;0;0,0;0;0,0
3544103;Rio Grande da Serra;2021;0;0,0;0;0,0;0;0,0
3544400;Rubiácea;2021;0;0,0;0;0,0;0;0,0
3544509;Rubinéia;2021;0;0,0;0;0,0;0;0,0
3544608;Sabino;2021;0;0,0;0;0,0;0;0,0
3544707;Sagres;2021;0;0,0;0;0,0;0;0,0
3544806;Sales;2021;0;0,0;0;0,0;0;0,0
3545100;Salmourão;2021;0;0,0;0;0,0;0;0,0
3545159;Saltinho;2021;0;0,0;0;0,0;0;0,0
3545506;Sandovalina;2021;0;0,0;0;0,0;0;0,0
3545704;Santa Albertina;2021;0;0,0;0;0,0;0;0,0
3546009;Santa Branca;2021;0;0,0;0;0,0;0;0,0
3546108;Santa Clara d'Oeste;2021;0;0,0;0;0,0;0;0,0
3546207;Santa Cruz da Conceição;2021;0;0,0;0;0,0;0;0,0
3546256;Santa Cruz da Esperança;2021;0;0,0;0;0,0;0;0,0
3546504;Santa Ernestina;2021;0;0,0;0;0,0;0;0,0
3546702;Santa Gertrudes;2021;0;0,0;0;0,0;0;0,0
3547106;Santa Mercedes;2021;0;0,0;0;0,0;0;0,0
3547205;Santana da Ponte Pensa;2021;0;0,0;0;0,0;0;0,0
3547403;Santa Rita d'Oeste;2021;0;0,0;0;0,0;0;0,0
3547650;Santa Salete;2021;0;0,0;0;0,0;0;0,0
3548005;Santo Antônio de Posse;2021;0;0,0;0;0,0;0;0,0
3548054;Santo Antônio do Aracanguá;2021;0;0,0;0;0,0;0;0,0
3548104;Santo Antônio do Jardim;2021;0;0,0;0;0,0;0;0,0
3548203;Santo Antônio do Pinhal;2021;0;0,0;0;0,0;0;0,0
3548302;Santo Expedito;2021;0;0,0;0;0,0;0;0,0
3548401;Santópolis do Aguapeí;2021;0;0,0;0;0,0;0;0,0
3549003;São Francisco;2021;0;0,0;0;0,0;0;0,0
3549201;São João das Duas Pontes;2021;0;0,0;0;0,0;0;0,0
3549250;São João de Iracema;2021;0;0,0;0;0,0;0;0,0
3549300;São João do Pau d'Alho;2021;0;0,0;0;0,0;0;0,0
3549508;São José da Bela Vista;2021;0;0,0;0;0,0;0;0,0
3549607;São José do Barreiro;2021;0;0,0;0;0,0;0;0,0
3550506;São Pedro do Turvo;2021;0;0,0;0;0,0;0;0,0
3551108;Sarapuí;2021;0;0,0;0;0,0;0;0,0
3551207;Sarutaiá;2021;0;0,0;0;0,0;0;0,0
3551306;Sebastianópolis do Sul;2021;0;0,0;0;0,0;0;0,0
3551405;Serra Azul;2021;0;0,0;0;0,0;0;0,0
3551801;Sete Barras;2021;0;0,0;0;0,0;0;0,0
3551900;Severínia;2021;0;0,0;0;0,0;0;0,0
3552551;Suzanápolis;2021;0;0,0;0;0,0;0;0,0
3552908;Taciba;2021;0;0,0;0;0,0;0;0,0
3553104;Taiaçu;2021;0;0,0;0;0,0;0;0,0
3553500;Tapiraí;2021;0;0,0;0;0,0;0;0,0
3553658;Taquaral;2021;0;0,0;0;0,0;0;0,0
3553856;Taquarivaí;2021;0;0,0;0;0,0;0;0,0
3553906;Tarabai;2021;0;0,0;0;0,0;0;0,0
3553955;Tarumã;2021;0;0,0;0;0,0;0;0,0
3554201;Tejupá;2021;0;0,0;0;0,0;0;0,0
3554607;Timburi;2021;0;0,0;0;0,0;0;0,0
3554656;Torre de Pedra;2021;0;0,0;0;0,0;0;0,0
3554755;Trabiju;2021;0;0,0;0;0,0;0;0,0
3554805;Tremembé;2021;0;0,0;0;0,0;0;0,0
3554904;Três Fronteiras;2021;0;0,0;0;0,0;0;0,0
3554953;Tuiuti;2021;0;0,0;0;0,0;0;0,0
3555208;Turiúba;2021;0;0,0;0;0,0;0;0,0
3555307;Turmalina;2021;0;0,0;0;0,0;0;0,0
3555356;Ubarana;2021;0;0,0;0;0,0;0;0,0
3555505;Ubirajara;2021;0;0,0;0;0,0;0;0,0
3555604;Uchoa;2021;0;0,0;0;0,0;0;0,0
3555703;União Paulista;2021;0;0,0;0;0,0;0;0,0
3555901;Uru;2021;0;0,0;0;0,0;0;0,0
3556107;Valentim Gentil;2021;0;0,0;0;0,0;0;0,0
3556354;Vargem;2021;0;0,0;0;0,0;0;0,0
3556453;Vargem Grande Paulista;2021;0;0,0;0;0,0;0;0,0
3556909;Vista Alegre do Alto;2021;0;0,0;0;0,0;0;0,0
3556958;Vitória Brasil;2021;0;0,0;0;0,0;0;0,0
3557154;Zacarias;2021;0;0,0;0;0,0;0;0,0
3557303;Estiva Gerbi;2021;0;0,0;0;0,0;0;0,0
3501707;Américo Brasiliense;2021;193;4,7;193;4,7;0;0,0
3503109;Arandu;2021;6;1,0;6;1,0;0;0,0
3504909;Bananal;2021;15;1,4;15;1,4;0;0,0
3506300;Bernardino de Campos;2021;28;2,6;28;2,6;0;0,0
3506359;Bertioga;2021;50;0,8;50;0,8;0;0,0
3506607;Biritiba Mirim;2021;4;0,1;4;0,1;0;0,0
3507100;Bom Jesus dos Perdões;2021;11;0,4;11;0,4;0;0,0
3508603;Cachoeira Paulista;2021;31;1,0;31;1,0;0;0,0
3508702;Caconde;2021;62;3,3;62;3,3;0;0,0
3509601;Campo Limpo Paulista;2021;54;0,6;54;0,6;0;0,0
3512100;Colômbia;2021;20;3,3;20;3,3;0;0,0
3512308;Conchas;2021;12;0,7;12;0,7;0;0,0
3512605;Coronel Macedo;2021;6;1,2;6;1,2;0;0,0
3512704;Corumbataí;2021;1;0,3;1;0,3;0;0,0
3513900;Divinolândia;2021;186;17,1;186;17,1;0;0,0
3514304;Dourado;2021;17;2,0;17;2,0;0;0,0
3514809;Eldorado;2021;2;0,1;2;0,1;0;0,0
3514908;Elias Fausto;2021;6;0,3;6;0,3;0;0,0
3515103;Embu-Guaçu;2021;17;0,2;17;0,2;0;0,0
3515707;Ferraz de Vasconcelos;2021;189;1,0;189;1,0;0;0,0
3516309;Francisco Morato;2021;164;0,9;164;0,9;0;0,0
3517604;Guapiara;2021;27;1,5;27;1,5;0;0,0
3519006;Herculândia;2021;58;6,2;58;6,2;0;0,0
3519303;Ibaté;2021;27;0,8;27;0,8;0;0,0
3519907;Iepê;2021;18;2,3;18;2,3;0;0,0
3520202;Igaratá;2021;8;0,9;8;0,9;0;0,0
3520301;Iguape;2021;9;0,3;9;0,3;0;0,0
3520400;Ilhabela;2021;59;1,7;59;1,7;0;0,0
3521002;Iperó;2021;15;0,4;15;0,4;0;0,0
3521408;Iracemápolis;2021;13;0,5;13;0,5;0;0,0
3521705;Itaberá;2021;19;1,1;19;1,1;0;0,0
3521804;Itaí;2021;35;1,3;35;1,3;0;0,0
3522901;Itapuí;2021;30;2,2;30;2,2;0;0,0
3523602;Itirapina;2021;22;1,3;22;1,3;0;0,0
3523909;Itu;2021;298;1,7;298;1,7;0;0,0
3524204;Jaborandi;2021;17;2,5;17;2,5;0;0,0
3525508;Joanópolis;2021;11;0,9;11;0,9;0;0,0
3526209;Juquitiba;2021;20;0,7;20;0,7;0;0,0
3529807;Mineiros do Tietê;2021;11;0,9;11;0,9;0;0,0
3530102;Mirandópolis;2021;68;2,4;68;2,4;0;0,0
3530201;Mirante do Paranapanema;2021;20;1,1;20;1,1;0;0,0
3532405;Nazaré Paulista;2021;20;1,1;20;1,1;0;0,0
3533403;Nova Odessa;2021;43;0,7;43;0,7;0;0,0
3535408;Panorama;2021;31;2,0;31;2,0;0;0,0
3535804;Paranapanema;2021;15;0,7;15;0,7;0;0,0
3536208;Pariquera-Açu;2021;166;8,6;166;8,6;0;0,0
3536505;Paulínia;2021;118;1,1;118;1,1;0;0,0
3537107;Pedreira;2021;98;2,1;98;2,1;0;0,0
3537206;Pedro de Toledo;2021;3;0,3;3;0,3;0;0,0
3537602;Peruíbe;2021;14;0,2;14;0,2;0;0,0
3539806;Poá;2021;10;0,1;10;0,1;0;0,0
3541604;Promissão;2021;37;0,9;37;0,9;0;0,0
3541901;Queluz;2021;19;1,5;19;1,5;0;0,0
3543006;Ribeirão Branco;2021;32;1,8;32;1,8;0;0,0
3544251;Rosana;2021;80;4,4;80;4,4;0;0,0
3545001;Salesópolis;2021;9;0,5;9;0,5;0;0,0
3547007;Santa Maria da Serra;2021;6;1,0;6;1,0;0;0,0
3547304;Santana de Parnaíba;2021;59;0,4;59;0,4;0;0,0
3547908;Santo Antônio da Alegria;2021;16;2,4;16;2,4;0;0,0
3550209;São Miguel Arcanjo;2021;45;1,4;45;1,4;0;0,0
3552007;Silveiras;2021;2;0,3;2;0,3;0;0,0
3553203;Taiúva;2021;4;0,6;4;0,6;0;0,0
3507407;Borborema;2021;26;1,7;16;1,0;10;0,7
3509700;Campos do Jordão;2021;195;3,9;185;3,7;10;0,2
3514502;Duartina;2021;87;7,3;77;6,4;10;0,8
3521309;Ipuã;2021;39;2,4;29;1,8;10;0,6
3523206;Itararé;2021;61;1,2;51;1,0;10;0,2
3532009;Morungaba;2021;19;1,4;9;0,7;10;0,7
3535200;Palmeira d'Oeste;2021;25;2,7;15;1,6;10;1,1
3537305;Penápolis;2021;151;2,5;141;2,3;10;0,2
3541307;Presidente Epitácio;2021;78;1,8;68;1,6;10;0,2
3544905;Sales Oliveira;2021;30;2,6;20;1,7;10;0,9
3546306;Santa Cruz das Palmeiras;2021;35;1,0;25;0,7;10;0,3
3505203;Bariri;2021;50;1,5;43;1,3;7;0,2
3505807;Bastos;2021;30;1,5;23;1,1;7;0,3
3511409;Cerqueira César;2021;39;2,0;32;1,7;7;0,4
3511706;Charqueada;2021;33;1,9;26;1,5;7;0,4
3518602;Guariba;2021;66;1,7;59;1,5;7;0,2
3523503;Itatinga;2021;14;0,7;7;0,3;7;0,3
3552106;Socorro;2021;70;1,8;63;1,6;7;0,2
3554706;Torrinha;2021;20;2,1;13;1,3;7;0,7
3506805;Bocaina;2021;35;2,9;29;2,4;6;0,5
3507902;Brotas;2021;41;1,7;35;1,5;6;0,2
3509304;Cajobi;2021;27;2,7;21;2,1;6;0,6
3515202;Estrela d'Oeste;2021;37;4,6;31;3,8;6;0,7
3520103;Igarapava;2021;43;1,5;37;1,3;6;0,2
3528502;Mairiporã;2021;52;0,5;46;0,5;6;0,1
3531902;Morro Agudo;2021;47;1,4;41;1,3;6;0,2
3536000;Parapuã;2021;32;3,1;26;2,5;6;0,6
3536604;Paulo de Faria;2021;24;2,8;18;2,1;6;0,7
3536703;Pederneiras;2021;42;0,9;36;0,8;6;0,1
3542909;Ribeirão Bonito;2021;24;1,8;18;1,4;6;0,5
3550704;São Sebastião;2021;90;1,0;84;1,0;6;0,1
3554300;Teodoro Sampaio;2021;58;2,6;52;2,3;6;0,3
3500501;Águas de Lindóia;2021;30;1,6;22;1,2;8;0,4
3510203;Capão Bonito;2021;45;1,0;37;0,8;8;0,2
3510807;Casa Branca;2021;386;13,1;378;12,8;8;0,3
3513702;Descalvado;2021;40;1,2;32;1,0;8;0,2
3515400;Fartura;2021;20;1,3;12;0,8;8;0,5
3517703;Guará;2021;48;2,3;40;1,9;8;0,4
3517802;Guaraçaí;2021;23;2,7;15;1,8;8;1,0
3537909;Pilar do Sul;2021;35;1,2;27;1,0;8;0,3
3546900;Santa Lúcia;2021;8;0,9;0;0,0;8;0,9
3553302;Tambaú;2021;36;1,6;28;1,2;8;0,4
3504206;Auriflama;2021;40;2,8;35;2,4;5;0,3
3510005;Cândido Mota;2021;30;1,0;25;0,8;5;0,2
3529203;Martinópolis;2021;45;1,7;40;1,6;5;0,2
3532900;Nova Europa;2021;18;1,7;13;1,2;5;0,5
3534757;Ouroeste;2021;33;3,3;28;2,8;5;0,5
3534906;Pacaembu;2021;37;2,8;32;2,5;5;0,4
3537404;Pereira Barreto;2021;52;2,0;47;1,8;5;0,2
3540002;Pompéia;2021;31;1,4;26;1,2;5;0,2
3553005;Taguaí;2021;29;2,1;24;1,8;5;0,4
3501004;Altinópolis;2021;31;2,0;29;1,9;2;0,1
3501301;Álvares Machado;2021;20;0,8;18;0,8;2;0,1
3513108;Cravinhos;2021;15;0,4;13;0,4;2;0,1
3517000;Getulina;2021;38;3,5;36;3,3;2;0,2
3518305;Guararema;2021;33;1,1;31;1,0;2;0,1
3519105;Iacanga;2021;30;2,6;28;2,5;2;0,2
3524709;Jaguariúna;2021;77;1,4;75;1,4;2;0,0
3552304;Sud Mennucci;2021;22;2,8;20;2,6;2;0,3
3553609;Tapiratiba;2021;14;1,1;12;1,0;2;0,2
3555802;Urânia;2021;26;3,0;24;2,8;2;0,2
3510708;Cardoso;2021;31;2,6;12;1,0;19;1,6
3531506;Monte Azul Paulista;2021;70;3,9;51;2,8;19;1,0
3538808;Piraju;2021;68;2,4;49;1,7;19;0,7
3547700;Santo Anastácio;2021;56;2,8;37;1,8;19;0,9
3552601;Tabapuã;2021;30;2,5;11;0,9;19;1,6
3556404;Vargem Grande do Sul;2021;50;1,2;31;0,7;19;0,5
3508108;Buritama;2021;36;2,2;18;1,1;18;1,1
3516606;Gália;2021;45;6,9;27;4,1;18;2,8
3517406;Guaíra;2021;71;1,8;53;1,4;18;0,5
3519402;Ibirá;2021;27;2,2;9;0,7;18;1,5
3521903;Itajobi;2021;50;3,4;32;2,2;18;1,2
3526407;Laranjal Paulista;2021;46;1,6;28;1,0;18;0,6
3535309;Palmital;2021;54;2,5;36;1,7;18;0,8
3539509;Pitangueiras;2021;50;1,3;32;0,8;18;0,5
3553807;Taquarituba;2021;49;2,1;31;1,3;18;0,8
3555406;Ubatuba;2021;92;1,0;74;0,8;18;0,2
3507001;Boituva;2021;53;0,9;41;0,7;12;0,2
3511508;Cerquilho;2021;38;0,8;26;0,6;12;0,3
3512001;Colina;2021;63;3,6;51;2,9;12;0,7
3512209;Conchal;2021;48;1,7;36;1,3;12;0,4
3522802;Itaporanga;2021;41;2,8;29;2,0;12;0,8
3525201;Jarinu;2021;29;1,0;17;0,6;12;0,4
3536307;Patrocínio Paulista;2021;35;2,4;23;1,6;12;0,8
3540606;Porto Feliz;2021;47;0,9;35;0,7;12;0,2
3545407;Salto Grande;2021;34;3,7;22;2,4;12;1,3
3546801;Santa Isabel;2021;76;1,4;64;1,2;12;0,2
3550407;São Pedro;2021;62;1,8;50;1,5;12;0,3
3502705;Apiaí;2021;55;2,2;51;2,1;4;0,2
3511607;Cesário Lange;2021;27;1,6;23;1,3;4;0,2
3527306;Louveira;2021;32;0,7;28;0,6;4;0,1
3528809;Maracaí;2021;26;1,9;22;1,6;4;0,3
3540200;Pontal;2021;25;0,5;21;0,4;4;0,1
3540804;Potirendaba;2021;31;1,9;27;1,6;4;0,2
3544004;Rio das Pedras;2021;36;1,0;32;0,9;4;0,1
3550803;São Sebastião da Grama;2021;30;2,5;26;2,2;4;0,3
3550902;São Simão;2021;40;2,7;36;2,4;4;0,3
3556503;Várzea Paulista;2021;35;0,3;31;0,3;4;0,0
3501103;Alto Alegre;2021;22;5,5;19;4,7;3;0,7
3502200;Angatuba;2021;57;2,3;54;2,2;3;0,1
3511904;Clementina;2021;24;2,9;21;2,5;3;0,4
3528106;Macaubal;2021;18;2,3;15;1,9;3;0,4
3539400;Piratininga;2021;44;3,3;41;3,1;3;0,2
3543808;Rinópolis;2021;23;2,4;20;2,1;3;0,3
3550100;São Manuel;2021;26;0,7;23;0,6;3;0,1
3508801;Cafelândia;2021;48;2,8;37;2,1;11;0,6
3520905;Ipaussu;2021;49;3,4;38;2,6;11;0,8
3532504;Neves Paulista;2021;21;2,4;10;1,2;11;1,3
3540408;Populina;2021;18;4,5;7;1,8;11;2,8
3541208;Presidente Bernardes;2021;51;3,7;40;2,9;11;0,8
3528007;Macatuba;2021;31;1,8;18;1,1;13;0,8
3547601;Santa Rosa de Viterbo;2021;32;1,2;19;0,7;13;0,5
3551504;Serrana;2021;125;2,8;112;2,5;13;0,3
3552700;Tabatinga;2021;35;2,2;22;1,4;13;0,8
3526001;Junqueirópolis;2021;46;2,3;25;1,2;21;1,0
3529708;Miguelópolis;2021;95;4,4;74;3,4;21;1,0
3516903;General Salgado;2021;28;2,6;19;1,8;9;0,8
3531803;Monte Mor;2021;35;0,6;26;0,4;9;0,1
3537008;Pedregulho;2021;64;3,9;55;3,4;9;0,6
3542404;Regente Feijó;2021;40;2,0;31;1,6;9;0,5
3545308;Salto de Pirapora;2021;52;1,2;43;1,0;9;0,2
3552403;Sumaré;2021;201;0,7;192;0,7;9;0,0
3514106;Dois Córregos;2021;67;2,5;47;1,7;20;0,7
3537800;Piedade;2021;79;1,5;59;1,1;20;0,4
3513603;Cunha;2021;40;1,8;25;1,2;15;0,7
3525003;Jandira;2021;18;0,1;3;0,0;15;0,1
3500105;Adamantina;2021;235;6,9;206;6,1;29;0,9
3500709;Agudos;2021;55;1,5;39;1,1;16;0,4
3501152;Alumínio;2021;120;6,6;0;0,0;120;6,6
3501608;Americana;2021;485;2,1;193;0,8;292;1,2
3501905;Amparo;2021;380;5,4;220;3,1;160;2,3
3502101;Andradina;2021;118;2,1;83;1,5;35;0,6
3502507;Aparecida;2021;92;2,6;69;1,9;23;0,6
3502606;Aparecida d'Oeste;2021;14;3,4;13;3,2;1;0,2
3502804;Araçatuba;2021;445;2,3;281;1,5;164;0,9
3502903;Araçoiaba da Serra;2021;329;10,0;8;0,2;321;9,8
3503208;Araraquara;2021;499;2,2;299;1,3;200;0,9
3503307;Araras;2021;499;3,8;252;1,9;247;1,9
3503406;Arealva;2021;32;3,9;15;1,8;17;2,1
3503802;Artur Nogueira;2021;63;1,2;0;0,0;63;1,2
3503901;Arujá;2021;97;1,1;29;0,3;68;0,7
3504008;Assis;2021;302;3,0;169;1,7;133;1,3
3504107;Atibaia;2021;192;1,4;55;0,4;137;1,0
3504503;Avaré;2021;159;1,8;95;1,1;64;0,7
3505302;Barra Bonita;2021;91;2,6;59;1,7;32;0,9
3505500;Barretos;2021;515;4,3;393;3,3;122;1,0
3505708;Barueri;2021;464;1,7;388;1,5;76;0,3
3505906;Batatais;2021;134;2,2;102;1,7;32;0,5
3506003;Bauru;2021;1.291;3,5;689;1,9;602;1,6
3506102;Bebedouro;2021;149;2,0;84;1,1;65;0,9
3506409;Bilac;2021;36;4,6;35;4,5;1;0,1
3506508;Birigui;2021;146;1,2;66;0,5;80;0,7
3506706;Boa Esperança do Sul;2021;16;1,1;15;1,0;1;0,1
3507506;Botucatu;2021;744;5,2;556;3,9;188;1,3
3507605;Bragança Paulista;2021;371;2,2;212;1,3;159;1,0
3508405;Cabreúva;2021;66;1,3;13;0,3;53;1,1
3508504;Caçapava;2021;184;2,0;59;0,6;125;1,4
3509007;Caieiras;2021;128;1,3;74;0,7;54;0,5
3509205;Cajamar;2021;125;1,6;25;0,3;100;1,3
3509403;Cajuru;2021;140;5,4;55;2,1;85;3,3
3509502;Campinas;2021;2.771;2,3;1.409;1,2;1.362;1,2
3510302;Capela do Alto;2021;59;2,8;14;0,7;45;2,2
3510401;Capivari;2021;110;2,0;61;1,1;49;0,9
3510500;Caraguatatuba;2021;308;2,6;254;2,2;54;0,5
3510609;Carapicuíba;2021;270;0,7;220;0,6;50;0,1
3511102;Catanduva;2021;601;5,1;374;3,2;227;1,9
3511300;Cedral;2021;52;5,8;0;0,0;52;5,8
3512803;Cosmópolis;2021;71;1,0;31;0,4;40;0,6
3513009;Cotia;2021;363;1,4;132;0,5;231;0,9
3513405;Cruzeiro;2021;105;1,3;88;1,1;17;0,2
3513504;Cubatão;2021;120;0,9;96;0,7;24;0,2
3513801;Diadema;2021;638;1,6;569;1,4;69;0,2
3514403;Dracena;2021;150;3,3;115;2,6;35;0,8
3515004;Embu das Artes;2021;219;0,8;64;0,2;155;0,6
3515186;Espírito Santo do Pinhal;2021;446;10,5;346;8,1;100;2,3
3515509;Fernandópolis;2021;135;2,0;84;1,3;51;0,8
3516200;Franca;2021;613;1,8;428;1,2;185;0,5
3516408;Franco da Rocha;2021;671;4,4;621;4,0;50;0,3
3516705;Garça;2021;287;6,8;258;6,1;29;0,7
3518206;Guararapes;2021;74;2,3;48;1,5;26;0,8
3518404;Guaratinguetá;2021;277;2,3;133;1,1;144;1,2
3518701;Guarujá;2021;415;1,3;312;1,0;103;0,3
3518800;Guarulhos;2021;1.935;1,4;1.496;1,1;439;0,3
3519071;Hortolândia;2021;99;0,4;77;0,3;22;0,1
3519600;Ibitinga;2021;104;1,8;47;0,8;57;1,0
3519709;Ibiúna;2021;217;2,8;59;0,8;158;2,1
3520442;Ilha Solteira;2021;110;4,3;74;2,9;36;1,4
3520509;Indaiatuba;2021;379;1,5;221;0,9;158;0,6
3520707;Indiaporã;2021;36;9,4;4;1,0;32;8,3
3522109;Itanhaém;2021;135;1,4;108;1,1;27;0,3
3522208;Itapecerica da Serra;2021;647;3,8;192;1,1;455;2,7
3522307;Itapetininga;2021;162;1,0;120;0,7;42;0,3
3522406;Itapeva;2021;157;1,7;112;1,2;45;0,5
3522505;Itapevi;2021;397;1,6;261;1,1;136;0,6
3522604;Itapira;2021;926;12,9;565;7,9;361;5,0
3522703;Itápolis;2021;65;1,6;39;0,9;26;0,6
3523107;Itaquaquecetuba;2021;253;0,7;229;0,6;24;0,1
3523404;Itatiba;2021;120;1,0;61;0,5;59;0,5
3524006;Itupeva;2021;86;1,4;48;0,8;38;0,6
3524105;Ituverava;2021;120;3,0;53;1,3;67;1,7
3524303;Jaboticabal;2021;212;2,9;49;0,7;163;2,2
3524402;Jacareí;2021;363;1,6;167;0,7;196;0,9
3524501;Jaci;2021;216;30,6;149;21,1;67;9,5
3524808;Jales;2021;151;3,2;103;2,2;48;1,0
3525300;Jaú;2021;1.025;6,9;700;4,7;325;2,2
3525706;José Bonifácio;2021;67;1,8;22;0,6;45;1,2
3525904;Jundiaí;2021;832;2,0;412;1,0;420;1,0
3526704;Leme;2021;122;1,2;84;0,8;38;0,4
3526803;Lençóis Paulista;2021;179;2,7;53;0,8;126;1,9
3526902;Limeira;2021;361;1,2;174;0,6;187;0,6
3527108;Lins;2021;442;5,9;334;4,4;108;1,4
3527207;Lorena;2021;158;1,8;68;0,8;90;1,0
3529005;Marília;2021;889;3,8;688;3,0;201;0,9
3529302;Matão;2021;162;2,0;100;1,2;62;0,8
3529401;Mauá;2021;481;1,0;214;0,5;267;0,6
3530508;Mococa;2021;125;1,9;78;1,2;47;0,7
3530607;Mogi das Cruzes;2021;857;2,0;599;1,4;258;0,6
3530706;Mogi Guaçu;2021;379;2,5;187;1,3;192;1,3
3530805;Mogi Mirim;2021;186;2,1;121;1,3;65;0,7
3531100;Mongaguá;2021;90;1,6;36;0,7;54;1,0
3531308;Monte Alto;2021;109;2,2;58;1,2;51;1,1
3532603;Nhandeara;2021;129;12,0;35;3,3;94;8,7
3533007;Nova Granada;2021;62;2,9;19;0,9;43;2,0
3533502;Novo Horizonte;2021;83;2,1;47;1,2;36;0,9
3533908;Olímpia;2021;79;1,5;41;0,8;38;0,7
3534302;Orlândia;2021;98;2,3;60;1,4;38;0,9
3534401;Osasco;2021;906;1,3;608;0,9;298;0,4
3534609;Osvaldo Cruz;2021;71;2,3;47;1,5;24;0,8
3534708;Ourinhos;2021;162;1,5;83;0,7;79;0,7
3535507;Paraguaçu Paulista;2021;96;2,2;73;1,6;23;0,5
3538006;Pindamonhangaba;2021;253;1,5;127;0,8;126;0,8
3538600;Piracaia;2021;51;1,9;29;1,1;22;0,8
3538709;Piracicaba;2021;690;1,8;335;0,9;355;0,9
3538907;Pirajuí;2021;285;12,2;84;3,6;201;8,6
3539004;Pirangi;2021;45;4,2;20;1,8;25;2,3
3539301;Pirassununga;2021;168;2,3;59;0,8;109;1,5
3540705;Porto Ferreira;2021;55;1,0;33;0,6;22;0,4
3541000;Praia Grande;2021;339;1,1;207;0,6;132;0,4
3541406;Presidente Prudente;2021;1.095;4,9;737;3,3;358;1,6
3541505;Presidente Venceslau;2021;96;2,5;60;1,6;36;0,9
3542206;Rancharia;2021;103;3,6;71;2,5;32;1,1
3542602;Registro;2021;182;3,4;147;2,7;35;0,6
3543303;Ribeirão Pires;2021;167;1,4;53;0,4;114;1,0
3543402;Ribeirão Preto;2021;2.226;3,2;1.409;2,0;817;1,2
3543907;Rio Claro;2021;350;1,7;205;1,0;145;0,7
3544202;Riolândia;2021;42;3,7;26;2,3;16;1,4
3544301;Roseira;2021;54;5,0;14;1,3;40;3,7
3545209;Salto;2021;160;1,4;116;1,0;44;0,4
3545605;Santa Adélia;2021;24;1,6;7;0,5;17;1,1
3545803;Santa Bárbara d'Oeste;2021;164;0,9;108;0,6;56;0,3
3546405;Santa Cruz do Rio Pardo;2021;96;2,1;55;1,2;41;0,9
3546603;Santa Fé do Sul;2021;80;2,6;58;1,9;22;0,7
3547502;Santa Rita do Passa Quatro;2021;311;11,8;288;10,9;23;0,9
3547809;Santo André;2021;1.526;2,2;755;1,1;771;1,1
3548500;Santos;2021;1.650;3,8;766;1,8;884;2,1
3548609;São Bento do Sapucaí;2021;40;3,8;26;2,5;14;1,3
3548708;São Bernardo do Campo;2021;1.878;2,3;836;1,0;1.042;1,3
3548807;São Caetano do Sul;2021;745;4,9;177;1,2;568;3,8
3548906;São Carlos;2021;525;2,2;231;0,9;294;1,2
3549102;São João da Boa Vista;2021;199;2,3;94;1,1;105;1,2
3549409;São Joaquim da Barra;2021;115;2,3;68;1,3;47;0,9
3549706;São José do Rio Pardo;2021;138;2,6;78;1,5;60;1,1
3549805;São José do Rio Preto;2021;2.102;4,7;894;2,0;1.208;2,7
3549904;São José dos Campos;2021;1.608;2,2;731;1,0;877;1,2
3549953;São Lourenço da Serra;2021;73;4,6;13;0,8;60;3,8
3550001;São Luiz do Paraitinga;2021;11;1,0;10;0,9;1;0,1
3550308;São Paulo;2021;29.947;2,5;15.997;1,3;13.950;1,2
3550605;São Roque;2021;268;3,0;62;0,7;206;2,3
3551009;São Vicente;2021;258;0,7;158;0,4;100;0,3
3551603;Serra Negra;2021;49;1,8;33;1,2;16;0,6
3551702;Sertãozinho;2021;136;1,1;65;0,5;71;0,6
3552205;Sorocaba;2021;1.449;2,2;869;1,3;580;0,9
3552502;Suzano;2021;237;0,8;86;0,3;151;0,5
3552809;Taboão da Serra;2021;460;1,6;299;1,0;161;0,6
3553708;Taquaritinga;2021;120;2,2;72;1,3;48;0,9
3554003;Tatuí;2021;105;0,9;59;0,5;46;0,4
3554102;Taubaté;2021;524;1,7;330;1,1;194;0,6
3554508;Tietê;2021;55;1,3;33;0,8;22;0,5
3555000;Tupã;2021;350;5,6;334;5,3;16;0,3
3556008;Urupês;2021;34;2,6;11;0,8;23;1,7
3556206;Valinhos;2021;142;1,1;56;0,4;86;0,7
3556305;Valparaíso;2021;55;2,3;31;1,3;24;1,0
3556602;Vera Cruz;2021;72;6,9;0;0,0;72;6,9
3556701;Vinhedo;2021;85;1,1;62;0,8;23;0,3
3557006;Votorantim;2021;237;2,0;78;0,6;159;1,3
3557105;Votuporanga;2021;215;2,3;115;1,2;100;1,1
3511003;Castilho;2021;31;1,5;30;1,4;1;0,0
3516002;Flórida Paulista;2021;47;3,9;30;2,5;17;1,4
3527405;Lucélia;2021;36;1,7;30;1,4;6;0,3
3530300;Mirassol;2021;81;1,4;30;0,5;51;0,9
3531407;Monte Aprazível;2021;80;3,4;30;1,3;50;2,1
3553401;Tanabi;2021;72;2,9;30;1,2;42;1,7
3554409;Terra Roxa;2021;34;3,7;30;3,3;4;0,4
3555109;Tupi Paulista;2021;48;3,2;30;2,0;18;1,2
3556800;Viradouro;2021;48;2,6;30;1,6;18;1,0
3557204;Chavantes;2021;51;4,2;30;2,5;21;1,7
3500204;Adolfo;2020;0;0,0;0;0,0;0;0,0
3500303;Aguaí;2020;0;0,0;0;0,0;0;0,0
3500402;Águas da Prata;2020;0;0,0;0;0,0;0;0,0
3500550;Águas de Santa Bárbara;2020;0;0,0;0;0,0;0;0,0
3500600;Águas de São Pedro;2020;0;0,0;0;0,0;0;0,0
3500758;Alambari;2020;0;0,0;0;0,0;0;0,0
3500808;Alfredo Marcondes;2020;0;0,0;0;0,0;0;0,0
3500907;Altair;2020;0;0,0;0;0,0;0;0,0
3501152;Alumínio;2020;0;0,0;0;0,0;0;0,0
3501202;Álvares Florence;2020;0;0,0;0;0,0;0;0,0
3501400;Álvaro de Carvalho;2020;0;0,0;0;0,0;0;0,0
3501509;Alvinlândia;2020;0;0,0;0;0,0;0;0,0
3501806;Américo de Campos;2020;0;0,0;0;0,0;0;0,0
3502002;Analândia;2020;0;0,0;0;0,0;0;0,0
3502309;Anhembi;2020;0;0,0;0;0,0;0;0,0
3502408;Anhumas;2020;0;0,0;0;0,0;0;0,0
3502754;Araçariguama;2020;0;0,0;0;0,0;0;0,0
3503000;Aramina;2020;0;0,0;0;0,0;0;0,0
3503158;Arapeí;2020;0;0,0;0;0,0;0;0,0
3503356;Arco-Íris;2020;0;0,0;0;0,0;0;0,0
3503505;Areias;2020;0;0,0;0;0,0;0;0,0
3503604;Areiópolis;2020;0;0,0;0;0,0;0;0,0
3503703;Ariranha;2020;0;0,0;0;0,0;0;0,0
3503950;Aspásia;2020;0;0,0;0;0,0;0;0,0
3504305;Avaí;2020;0;0,0;0;0,0;0;0,0
3504404;Avanhandava;2020;0;0,0;0;0,0;0;0,0
3504602;Bady Bassitt;2020;0;0,0;0;0,0;0;0,0
3504701;Balbinos;2020;0;0,0;0;0,0;0;0,0
3504800;Bálsamo;2020;0;0,0;0;0,0;0;0,0
3505005;Barão de Antonina;2020;0;0,0;0;0,0;0;0,0
3505104;Barbosa;2020;0;0,0;0;0,0;0;0,0
3505351;Barra do Chapéu;2020;0;0,0;0;0,0;0;0,0
3505401;Barra do Turvo;2020;0;0,0;0;0,0;0;0,0
3505609;Barrinha;2020;0;0,0;0;0,0;0;0,0
3506201;Bento de Abreu;2020;0;0,0;0;0,0;0;0,0
3506607;Biritiba Mirim;2020;0;0,0;0;0,0;0;0,0
3506904;Bofete;2020;0;0,0;0;0,0;0;0,0
3507159;Bom Sucesso de Itararé;2020;0;0,0;0;0,0;0;0,0
3507209;Borá;2020;0;0,0;0;0,0;0;0,0
3507308;Boracéia;2020;0;0,0;0;0,0;0;0,0
3507456;Borebi;2020;0;0,0;0;0,0;0;0,0
3507704;Braúna;2020;0;0,0;0;0,0;0;0,0
3507753;Brejo Alegre;2020;0;0,0;0;0,0;0;0,0
3507803;Brodowski;2020;0;0,0;0;0,0;0;0,0
3508009;Buri;2020;0;0,0;0;0,0;0;0,0
3508207;Buritizal;2020;0;0,0;0;0,0;0;0,0
3508306;Cabrália Paulista;2020;0;0,0;0;0,0;0;0,0
3508900;Caiabu;2020;0;0,0;0;0,0;0;0,0
3509106;Caiuá;2020;0;0,0;0;0,0;0;0,0
3509254;Cajati;2020;0;0,0;0;0,0;0;0,0
3509452;Campina do Monte Alegre;2020;0;0,0;0;0,0;0;0,0
3509809;Campos Novos Paulista;2020;0;0,0;0;0,0;0;0,0
3509908;Cananéia;2020;0;0,0;0;0,0;0;0,0
3509957;Canas;2020;0;0,0;0;0,0;0;0,0
3510104;Cândido Rodrigues;2020;0;0,0;0;0,0;0;0,0
3510153;Canitar;2020;0;0,0;0;0,0;0;0,0
3510906;Cássia dos Coqueiros;2020;0;0,0;0;0,0;0;0,0
3511201;Catiguá;2020;0;0,0;0;0,0;0;0,0
3512407;Cordeirópolis;2020;0;0,0;0;0,0;0;0,0
3512506;Coroados;2020;0;0,0;0;0,0;0;0,0
3512704;Corumbataí;2020;0;0,0;0;0,0;0;0,0
3512902;Cosmorama;2020;0;0,0;0;0,0;0;0,0
3513207;Cristais Paulista;2020;0;0,0;0;0,0;0;0,0
3513306;Cruzália;2020;0;0,0;0;0,0;0;0,0
3513850;Dirce Reis;2020;0;0,0;0;0,0;0;0,0
3514007;Dobrada;2020;0;0,0;0;0,0;0;0,0
3514205;Dolcinópolis;2020;0;0,0;0;0,0;0;0,0
3514601;Dumont;2020;0;0,0;0;0,0;0;0,0
3514700;Echaporã;2020;0;0,0;0;0,0;0;0,0
3514924;Elisiário;2020;0;0,0;0;0,0;0;0,0
3514957;Embaúba;2020;0;0,0;0;0,0;0;0,0
3515129;Emilianópolis;2020;0;0,0;0;0,0;0;0,0
3515152;Engenheiro Coelho;2020;0;0,0;0;0,0;0;0,0
3515194;Espírito Santo do Turvo;2020;0;0,0;0;0,0;0;0,0
3515301;Estrela do Norte;2020;0;0,0;0;0,0;0;0,0
3515350;Euclides da Cunha Paulista;2020;0;0,0;0;0,0;0;0,0
3515608;Fernando Prestes;2020;0;0,0;0;0,0;0;0,0
3515657;Fernão;2020;0;0,0;0;0,0;0;0,0
3515806;Flora Rica;2020;0;0,0;0;0,0;0;0,0
3515905;Floreal;2020;0;0,0;0;0,0;0;0,0
3516101;Florínea;2020;0;0,0;0;0,0;0;0,0
3516507;Gabriel Monteiro;2020;0;0,0;0;0,0;0;0,0
3516804;Gastão Vidigal;2020;0;0,0;0;0,0;0;0,0
3516853;Gavião Peixoto;2020;0;0,0;0;0,0;0;0,0
3517109;Glicério;2020;0;0,0;0;0,0;0;0,0
3517208;Guaiçara;2020;0;0,0;0;0,0;0;0,0
3517307;Guaimbê;2020;0;0,0;0;0,0;0;0,0
3517505;Guapiaçu;2020;0;0,0;0;0,0;0;0,0
3517901;Guaraci;2020;0;0,0;0;0,0;0;0,0
3518008;Guarani d'Oeste;2020;0;0,0;0;0,0;0;0,0
3518107;Guarantã;2020;0;0,0;0;0,0;0;0,0
3518503;Guareí;2020;0;0,0;0;0,0;0;0,0
3518859;Guatapará;2020;0;0,0;0;0,0;0;0,0
3518909;Guzolândia;2020;0;0,0;0;0,0;0;0,0
3519055;Holambra;2020;0;0,0;0;0,0;0;0,0
3519204;Iacri;2020;0;0,0;0;0,0;0;0,0
3519253;Iaras;2020;0;0,0;0;0,0;0;0,0
3519501;Ibirarema;2020;0;0,0;0;0,0;0;0,0
3519808;Icém;2020;0;0,0;0;0,0;0;0,0
3520004;Igaraçu do Tietê;2020;0;0,0;0;0,0;0;0,0
3520426;Ilha Comprida;2020;0;0,0;0;0,0;0;0,0
3520608;Indiana;2020;0;0,0;0;0,0;0;0,0
3520806;Inúbia Paulista;2020;0;0,0;0;0,0;0;0,0
3521101;Ipeúna;2020;0;0,0;0;0,0;0;0,0
3521150;Ipiguá;2020;0;0,0;0;0,0;0;0,0
3521200;Iporanga;2020;0;0,0;0;0,0;0;0,0
3521507;Irapuã;2020;0;0,0;0;0,0;0;0,0
3521606;Irapuru;2020;0;0,0;0;0,0;0;0,0
3522000;Itaju;2020;0;0,0;0;0,0;0;0,0
3522158;Itaoca;2020;0;0,0;0;0,0;0;0,0
3522653;Itapirapuã Paulista;2020;0;0,0;0;0,0;0;0,0
3523008;Itapura;2020;0;0,0;0;0,0;0;0,0
3523305;Itariri;2020;0;0,0;0;0,0;0;0,0
3523701;Itirapuã;2020;0;0,0;0;0,0;0;0,0
3523800;Itobi;2020;0;0,0;0;0,0;0;0,0
3524600;Jacupiranga;2020;0;0,0;0;0,0;0;0,0
3524907;Jambeiro;2020;0;0,0;0;0,0;0;0,0
3525102;Jardinópolis;2020;0;0,0;0;0,0;0;0,0
3525409;Jeriquara;2020;0;0,0;0;0,0;0;0,0
3525607;João Ramalho;2020;0;0,0;0;0,0;0;0,0
3525805;Júlio Mesquita;2020;0;0,0;0;0,0;0;0,0
3525854;Jumirim;2020;0;0,0;0;0,0;0;0,0
3526100;Juquiá;2020;0;0,0;0;0,0;0;0,0
3526308;Lagoinha;2020;0;0,0;0;0,0;0;0,0
3526506;Lavínia;2020;0;0,0;0;0,0;0;0,0
3526605;Lavrinhas;2020;0;0,0;0;0,0;0;0,0
3527009;Lindóia;2020;0;0,0;0;0,0;0;0,0
3527256;Lourdes;2020;0;0,0;0;0,0;0;0,0
3527504;Lucianópolis;2020;0;0,0;0;0,0;0;0,0
3527603;Luís Antônio;2020;0;0,0;0;0,0;0;0,0
3527801;Lupércio;2020;0;0,0;0;0,0;0;0,0
3527900;Lutécia;2020;0;0,0;0;0,0;0;0,0
3528205;Macedônia;2020;0;0,0;0;0,0;0;0,0
3528304;Magda;2020;0;0,0;0;0,0;0;0,0
3528403;Mairinque;2020;0;0,0;0;0,0;0;0,0
3528601;Manduri;2020;0;0,0;0;0,0;0;0,0
3528700;Marabá Paulista;2020;0;0,0;0;0,0;0;0,0
3528858;Marapoama;2020;0;0,0;0;0,0;0;0,0
3528908;Mariápolis;2020;0;0,0;0;0,0;0;0,0
3529104;Marinópolis;2020;0;0,0;0;0,0;0;0,0
3529500;Mendonça;2020;0;0,0;0;0,0;0;0,0
3529609;Meridiano;2020;0;0,0;0;0,0;0;0,0
3529658;Mesópolis;2020;0;0,0;0;0,0;0;0,0
3529906;Miracatu;2020;0;0,0;0;0,0;0;0,0
3530003;Mira Estrela;2020;0;0,0;0;0,0;0;0,0
3530201;Mirante do Paranapanema;2020;0;0,0;0;0,0;0;0,0
3530409;Mirassolândia;2020;0;0,0;0;0,0;0;0,0
3530904;Mombuca;2020;0;0,0;0;0,0;0;0,0
3531001;Monções;2020;0;0,0;0;0,0;0;0,0
3531209;Monte Alegre do Sul;2020;0;0,0;0;0,0;0;0,0
3531605;Monte Castelo;2020;0;0,0;0;0,0;0;0,0
3531704;Monteiro Lobato;2020;0;0,0;0;0,0;0;0,0
3532058;Motuca;2020;0;0,0;0;0,0;0;0,0
3532108;Murutinga do Sul;2020;0;0,0;0;0,0;0;0,0
3532157;Nantes;2020;0;0,0;0;0,0;0;0,0
3532207;Narandiba;2020;0;0,0;0;0,0;0;0,0
3532306;Natividade da Serra;2020;0;0,0;0;0,0;0;0,0
3532702;Nipoã;2020;0;0,0;0;0,0;0;0,0
3532801;Nova Aliança;2020;0;0,0;0;0,0;0;0,0
3532827;Nova Campina;2020;0;0,0;0;0,0;0;0,0
3532843;Nova Canaã Paulista;2020;0;0,0;0;0,0;0;0,0
3532868;Nova Castilho;2020;0;0,0;0;0,0;0;0,0
3533106;Nova Guataporanga;2020;0;0,0;0;0,0;0;0,0
3533205;Nova Independência;2020;0;0,0;0;0,0;0;0,0
3533254;Novais;2020;0;0,0;0;0,0;0;0,0
3533304;Nova Luzitânia;2020;0;0,0;0;0,0;0;0,0
3533601;Nuporanga;2020;0;0,0;0;0,0;0;0,0
3533700;Ocauçu;2020;0;0,0;0;0,0;0;0,0
3533809;Óleo;2020;0;0,0;0;0,0;0;0,0
3534005;Onda Verde;2020;0;0,0;0;0,0;0;0,0
3534104;Oriente;2020;0;0,0;0;0,0;0;0,0
3534203;Orindiúva;2020;0;0,0;0;0,0;0;0,0
3534500;Oscar Bressane;2020;0;0,0;0;0,0;0;0,0
3534807;Ouro Verde;2020;0;0,0;0;0,0;0;0,0
3535002;Palestina;2020;0;0,0;0;0,0;0;0,0
3535101;Palmares Paulista;2020;0;0,0;0;0,0;0;0,0
3535606;Paraibuna;2020;0;0,0;0;0,0;0;0,0
3535705;Paraíso;2020;0;0,0;0;0,0;0;0,0
3535903;Paranapuã;2020;0;0,0;0;0,0;0;0,0
3536109;Pardinho;2020;0;0,0;0;0,0;0;0,0
3536257;Parisi;2020;0;0,0;0;0,0;0;0,0
3536406;Paulicéia;2020;0;0,0;0;0,0;0;0,0
3536570;Paulistânia;2020;0;0,0;0;0,0;0;0,0
3536802;Pedra Bela;2020;0;0,0;0;0,0;0;0,0
3536901;Pedranópolis;2020;0;0,0;0;0,0;0;0,0
3537156;Pedrinhas Paulista;2020;0;0,0;0;0,0;0;0,0
3537206;Pedro de Toledo;2020;0;0,0;0;0,0;0;0,0
3537503;Pereiras;2020;0;0,0;0;0,0;0;0,0
3537701;Piacatu;2020;0;0,0;0;0,0;0;0,0
3538105;Pindorama;2020;0;0,0;0;0,0;0;0,0
3538204;Pinhalzinho;2020;0;0,0;0;0,0;0;0,0
3538303;Piquerobi;2020;0;0,0;0;0,0;0;0,0
3538501;Piquete;2020;0;0,0;0;0,0;0;0,0
3538600;Piracaia;2020;0;0,0;0;0,0;0;0,0
3539103;Pirapora do Bom Jesus;2020;0;0,0;0;0,0;0;0,0
3539202;Pirapozinho;2020;0;0,0;0;0,0;0;0,0
3539608;Planalto;2020;0;0,0;0;0,0;0;0,0
3539707;Platina;2020;0;0,0;0;0,0;0;0,0
3539905;Poloni;2020;0;0,0;0;0,0;0;0,0
3540101;Pongaí;2020;0;0,0;0;0,0;0;0,0
3540259;Pontalinda;2020;0;0,0;0;0,0;0;0,0
3540309;Pontes Gestal;2020;0;0,0;0;0,0;0;0,0
3540507;Porangaba;2020;0;0,0;0;0,0;0;0,0
3540754;Potim;2020;0;0,0;0;0,0;0;0,0
3540853;Pracinha;2020;0;0,0;0;0,0;0;0,0
3540903;Pradópolis;2020;0;0,0;0;0,0;0;0,0
3541059;Pratânia;2020;0;0,0;0;0,0;0;0,0
3541109;Presidente Alves;2020;0;0,0;0;0,0;0;0,0
3541653;Quadra;2020;0;0,0;0;0,0;0;0,0
3541703;Quatá;2020;0;0,0;0;0,0;0;0,0
3541802;Queiroz;2020;0;0,0;0;0,0;0;0,0
3542008;Quintana;2020;0;0,0;0;0,0;0;0,0
3542107;Rafard;2020;0;0,0;0;0,0;0;0,0
3542305;Redenção da Serra;2020;0;0,0;0;0,0;0;0,0
3542503;Reginópolis;2020;0;0,0;0;0,0;0;0,0
3542701;Restinga;2020;0;0,0;0;0,0;0;0,0
3542800;Ribeira;2020;0;0,0;0;0,0;0;0,0
3543105;Ribeirão Corrente;2020;0;0,0;0;0,0;0;0,0
3543204;Ribeirão do Sul;2020;0;0,0;0;0,0;0;0,0
3543238;Ribeirão dos Índios;2020;0;0,0;0;0,0;0;0,0
3543253;Ribeirão Grande;2020;0;0,0;0;0,0;0;0,0
3543501;Riversul;2020;0;0,0;0;0,0;0;0,0
3543600;Rifaina;2020;0;0,0;0;0,0;0;0,0
3543709;Rincão;2020;0;0,0;0;0,0;0;0,0
3544103;Rio Grande da Serra;2020;0;0,0;0;0,0;0;0,0
3544400;Rubiácea;2020;0;0,0;0;0,0;0;0,0
3544509;Rubinéia;2020;0;0,0;0;0,0;0;0,0
3544608;Sabino;2020;0;0,0;0;0,0;0;0,0
3544707;Sagres;2020;0;0,0;0;0,0;0;0,0
3544806;Sales;2020;0;0,0;0;0,0;0;0,0
3545100;Salmourão;2020;0;0,0;0;0,0;0;0,0
3545159;Saltinho;2020;0;0,0;0;0,0;0;0,0
3545506;Sandovalina;2020;0;0,0;0;0,0;0;0,0
3545704;Santa Albertina;2020;0;0,0;0;0,0;0;0,0
3546009;Santa Branca;2020;0;0,0;0;0,0;0;0,0
3546108;Santa Clara d'Oeste;2020;0;0,0;0;0,0;0;0,0
3546207;Santa Cruz da Conceição;2020;0;0,0;0;0,0;0;0,0
3546256;Santa Cruz da Esperança;2020;0;0,0;0;0,0;0;0,0
3546504;Santa Ernestina;2020;0;0,0;0;0,0;0;0,0
3546702;Santa Gertrudes;2020;0;0,0;0;0,0;0;0,0
3547106;Santa Mercedes;2020;0;0,0;0;0,0;0;0,0
3547205;Santana da Ponte Pensa;2020;0;0,0;0;0,0;0;0,0
3547403;Santa Rita d'Oeste;2020;0;0,0;0;0,0;0;0,0
3547650;Santa Salete;2020;0;0,0;0;0,0;0;0,0
3548005;Santo Antônio de Posse;2020;0;0,0;0;0,0;0;0,0
3548054;Santo Antônio do Aracanguá;2020;0;0,0;0;0,0;0;0,0
3548104;Santo Antônio do Jardim;2020;0;0,0;0;0,0;0;0,0
3548203;Santo Antônio do Pinhal;2020;0;0,0;0;0,0;0;0,0
3548302;Santo Expedito;2020;0;0,0;0;0,0;0;0,0
3548401;Santópolis do Aguapeí;2020;0;0,0;0;0,0;0;0,0
3549003;São Francisco;2020;0;0,0;0;0,0;0;0,0
3549201;São João das Duas Pontes;2020;0;0,0;0;0,0;0;0,0
3549250;São João de Iracema;2020;0;0,0;0;0,0;0;0,0
3549300;São João do Pau d'Alho;2020;0;0,0;0;0,0;0;0,0
3549508;São José da Bela Vista;2020;0;0,0;0;0,0;0;0,0
3549607;São José do Barreiro;2020;0;0,0;0;0,0;0;0,0
3549953;São Lourenço da Serra;2020;0;0,0;0;0,0;0;0,0
3550506;São Pedro do Turvo;2020;0;0,0;0;0,0;0;0,0
3551108;Sarapuí;2020;0;0,0;0;0,0;0;0,0
3551207;Sarutaiá;2020;0;0,0;0;0,0;0;0,0
3551306;Sebastianópolis do Sul;2020;0;0,0;0;0,0;0;0,0
3551405;Serra Azul;2020;0;0,0;0;0,0;0;0,0
3551801;Sete Barras;2020;0;0,0;0;0,0;0;0,0
3551900;Severínia;2020;0;0,0;0;0,0;0;0,0
3552551;Suzanápolis;2020;0;0,0;0;0,0;0;0,0
3552908;Taciba;2020;0;0,0;0;0,0;0;0,0
3553104;Taiaçu;2020;0;0,0;0;0,0;0;0,0
3553500;Tapiraí;2020;0;0,0;0;0,0;0;0,0
3553658;Taquaral;2020;0;0,0;0;0,0;0;0,0
3553856;Taquarivaí;2020;0;0,0;0;0,0;0;0,0
3553906;Tarabai;2020;0;0,0;0;0,0;0;0,0
3553955;Tarumã;2020;0;0,0;0;0,0;0;0,0
3554201;Tejupá;2020;0;0,0;0;0,0;0;0,0
3554607;Timburi;2020;0;0,0;0;0,0;0;0,0
3554656;Torre de Pedra;2020;0;0,0;0;0,0;0;0,0
3554755;Trabiju;2020;0;0,0;0;0,0;0;0,0
3554805;Tremembé;2020;0;0,0;0;0,0;0;0,0
3554904;Três Fronteiras;2020;0;0,0;0;0,0;0;0,0
3554953;Tuiuti;2020;0;0,0;0;0,0;0;0,0
3555208;Turiúba;2020;0;0,0;0;0,0;0;0,0
3555307;Turmalina;2020;0;0,0;0;0,0;0;0,0
3555356;Ubarana;2020;0;0,0;0;0,0;0;0,0
3555505;Ubirajara;2020;0;0,0;0;0,0;0;0,0
3555604;Uchoa;2020;0;0,0;0;0,0;0;0,0
3555703;União Paulista;2020;0;0,0;0;0,0;0;0,0
3555901;Uru;2020;0;0,0;0;0,0;0;0,0
3556107;Valentim Gentil;2020;0;0,0;0;0,0;0;0,0
3556354;Vargem;2020;0;0,0;0;0,0;0;0,0
3556909;Vista Alegre do Alto;2020;0;0,0;0;0,0;0;0,0
3556958;Vitória Brasil;2020;0;0,0;0;0,0;0;0,0
3557154;Zacarias;2020;0;0,0;0;0,0;0;0,0
3557303;Estiva Gerbi;2020;0;0,0;0;0,0;0;0,0
3501707;Américo Brasiliense;2020;193;4,8;193;4,8;0;0,0
3503109;Arandu;2020;12;1,9;12;1,9;0;0,0
3504909;Bananal;2020;15;1,4;15;1,4;0;0,0
3506300;Bernardino de Campos;2020;23;2,1;23;2,1;0;0,0
3506359;Bertioga;2020;59;0,9;59;0,9;0;0,0
3507100;Bom Jesus dos Perdões;2020;11;0,5;11;0,5;0;0,0
3508603;Cachoeira Paulista;2020;21;0,7;21;0,7;0;0,0
3508702;Caconde;2020;62;3,3;62;3,3;0;0,0
3509601;Campo Limpo Paulista;2020;68;0,8;68;0,8;0;0,0
3512100;Colômbia;2020;20;3,3;20;3,3;0;0,0
3512308;Conchas;2020;12;0,7;12;0,7;0;0,0
3512605;Coronel Macedo;2020;6;1,2;6;1,2;0;0,0
3513900;Divinolândia;2020;194;17,8;194;17,8;0;0,0
3514304;Dourado;2020;10;1,2;10;1,2;0;0,0
3514809;Eldorado;2020;2;0,1;2;0,1;0;0,0
3514908;Elias Fausto;2020;6;0,3;6;0,3;0;0,0
3515103;Embu-Guaçu;2020;17;0,2;17;0,2;0;0,0
3515707;Ferraz de Vasconcelos;2020;209;1,1;209;1,1;0;0,0
3516309;Francisco Morato;2020;164;0,9;164;0,9;0;0,0
3517604;Guapiara;2020;27;1,5;27;1,5;0;0,0
3519006;Herculândia;2020;58;6,3;58;6,3;0;0,0
3519303;Ibaté;2020;27;0,8;27;0,8;0;0,0
3519907;Iepê;2020;18;2,3;18;2,3;0;0,0
3520202;Igaratá;2020;8;0,9;8;0,9;0;0,0
3520301;Iguape;2020;9;0,3;9;0,3;0;0,0
3520400;Ilhabela;2020;59;1,8;59;1,8;0;0,0
3521002;Iperó;2020;15;0,4;15;0,4;0;0,0
3521408;Iracemápolis;2020;3;0,1;3;0,1;0;0,0
3521705;Itaberá;2020;19;1,1;19;1,1;0;0,0
3521804;Itaí;2020;35;1,3;35;1,3;0;0,0
3522109;Itanhaém;2020;141;1,4;141;1,4;0;0,0
3522901;Itapuí;2020;30;2,2;30;2,2;0;0,0
3523107;Itaquaquecetuba;2020;247;0,7;247;0,7;0;0,0
3523602;Itirapina;2020;22;1,3;22;1,3;0;0,0
3523909;Itu;2020;328;1,9;328;1,9;0;0,0
3524204;Jaborandi;2020;17;2,5;17;2,5;0;0,0
3525508;Joanópolis;2020;11;0,9;11;0,9;0;0,0
3527702;Luiziânia;2020;3;0,5;3;0,5;0;0,0
3529807;Mineiros do Tietê;2020;11;0,9;11;0,9;0;0,0
3530102;Mirandópolis;2020;68;2,4;68;2,4;0;0,0
3531100;Mongaguá;2020;36;0,7;36;0,7;0;0,0
3532405;Nazaré Paulista;2020;20;1,1;20;1,1;0;0,0
3533403;Nova Odessa;2020;67;1,2;67;1,2;0;0,0
3535408;Panorama;2020;31;2,0;31;2,0;0;0,0
3535804;Paranapanema;2020;13;0,7;13;0,7;0;0,0
3536208;Pariquera-Açu;2020;166;8,6;166;8,6;0;0,0
3536505;Paulínia;2020;97;0,9;97;0,9;0;0,0
3537107;Pedreira;2020;98;2,1;98;2,1;0;0,0
3537602;Peruíbe;2020;18;0,3;18;0,3;0;0,0
3539806;Poá;2020;35;0,3;35;0,3;0;0,0
3541604;Promissão;2020;37;0,9;37;0,9;0;0,0
3541901;Queluz;2020;19;1,5;19;1,5;0;0,0
3543006;Ribeirão Branco;2020;34;1,9;34;1,9;0;0,0
3544251;Rosana;2020;80;4,4;80;4,4;0;0,0
3547007;Santa Maria da Serra;2020;6;1,0;6;1,0;0;0,0
3547304;Santana de Parnaíba;2020;41;0,3;41;0,3;0;0,0
3547908;Santo Antônio da Alegria;2020;19;2,9;19;2,9;0;0,0
3550209;São Miguel Arcanjo;2020;48;1,5;48;1,5;0;0,0
3552007;Silveiras;2020;2;0,3;2;0,3;0;0,0
3553203;Taiúva;2020;4;0,6;4;0,6;0;0,0
3507001;Boituva;2020;48;0,8;38;0,7;10;0,2
3507407;Borborema;2020;26;1,7;16;1,0;10;0,7
3509700;Campos do Jordão;2020;201;4,0;191;3,8;10;0,2
3511508;Cerquilho;2020;48;1,0;38;0,8;10;0,2
3512209;Conchal;2020;52;1,9;42;1,5;10;0,4
3514502;Duartina;2020;87;7,3;77;6,4;10;0,8
3520103;Igarapava;2020;47;1,6;37;1,3;10;0,3
3521309;Ipuã;2020;39;2,5;29;1,8;10;0,6
3523206;Itararé;2020;61;1,2;51;1,0;10;0,2
3532009;Morungaba;2020;19;1,4;9;0,7;10;0,8
3535200;Palmeira d'Oeste;2020;20;2,2;10;1,1;10;1,1
3537305;Penápolis;2020;171;2,8;161;2,6;10;0,2
3541307;Presidente Epitácio;2020;78;1,8;68;1,6;10;0,2
3544905;Sales Oliveira;2020;30;2,6;20;1,7;10;0,9
3546306;Santa Cruz das Palmeiras;2020;35;1,0;25;0,7;10;0,3
3552700;Tabatinga;2020;35;2,2;25;1,6;10;0,6
3505807;Bastos;2020;35;1,7;28;1,4;7;0,3
3510203;Capão Bonito;2020;50;1,1;43;0,9;7;0,2
3511409;Cerqueira César;2020;39;2,0;32;1,7;7;0,4
3511706;Charqueada;2020;33;1,9;26;1,5;7;0,4
3518602;Guariba;2020;71;1,8;64;1,6;7;0,2
3523503;Itatinga;2020;14;0,7;7;0,3;7;0,3
3552106;Socorro;2020;70;1,8;63;1,6;7;0,2
3554706;Torrinha;2020;20;2,1;13;1,3;7;0,7
3501004;Altinópolis;2020;31;2,0;25;1,6;6;0,4
3506805;Bocaina;2020;35;2,9;29;2,4;6;0,5
3507902;Brotas;2020;41;1,7;35;1,5;6;0,3
3509304;Cajobi;2020;32;3,2;26;2,6;6;0,6
3515202;Estrela d'Oeste;2020;37;4,6;31;3,8;6;0,7
3518305;Guararema;2020;35;1,2;29;1,0;6;0,2
3527405;Lucélia;2020;32;1,5;26;1,2;6;0,3
3528502;Mairiporã;2020;77;0,8;71;0,7;6;0,1
3536000;Parapuã;2020;32;3,0;26;2,5;6;0,6
3536604;Paulo de Faria;2020;24;2,8;18;2,1;6;0,7
3536703;Pederneiras;2020;42;0,9;36;0,8;6;0,1
3542909;Ribeirão Bonito;2020;24;1,9;18;1,4;6;0,5
3554300;Teodoro Sampaio;2020;58;2,6;52;2,3;6;0,3
3500501;Águas de Lindóia;2020;30;1,6;22;1,2;8;0,4
3515400;Fartura;2020;20;1,3;12;0,8;8;0,5
3517703;Guará;2020;48;2,3;40;1,9;8;0,4
3517802;Guaraçaí;2020;23;2,7;15;1,8;8;1,0
3526209;Juquitiba;2020;8;0,3;0;0,0;8;0,3
3537909;Pilar do Sul;2020;35;1,2;27;1,0;8;0,3
3546900;Santa Lúcia;2020;8;0,9;0;0,0;8;0,9
3550704;São Sebastião;2020;137;1,6;129;1,5;8;0,1
3550902;São Simão;2020;40;2,7;32;2,2;8;0,5
3553302;Tambaú;2020;42;1,8;34;1,5;8;0,4
3502705;Apiaí;2020;56;2,3;51;2,1;5;0,2
3504206;Auriflama;2020;40;2,8;35;2,4;5;0,3
3508405;Cabreúva;2020;16;0,3;11;0,2;5;0,1
3510005;Cândido Mota;2020;30;1,0;25;0,8;5;0,2
3511607;Cesário Lange;2020;22;1,3;17;1,0;5;0,3
3529203;Martinópolis;2020;45;1,8;40;1,6;5;0,2
3532900;Nova Europa;2020;18;1,7;13;1,2;5;0,5
3534757;Ouroeste;2020;33;3,4;28;2,9;5;0,5
3534906;Pacaembu;2020;37;2,8;32;2,5;5;0,4
3537404;Pereira Barreto;2020;52;2,0;47;1,9;5;0,2
3540002;Pompéia;2020;18;0,8;13;0,6;5;0,2
3545308;Salto de Pirapora;2020;53;1,2;48;1,1;5;0,1
3552403;Sumaré;2020;197;0,7;192;0,7;5;0,0
3553005;Taguaí;2020;29;2,2;24;1,8;5;0,4
3501301;Álvares Machado;2020;20;0,8;18;0,8;2;0,1
3513108;Cravinhos;2020;15;0,4;13;0,4;2;0,1
3517000;Getulina;2020;38;3,5;36;3,3;2;0,2
3519105;Iacanga;2020;30;2,7;28;2,5;2;0,2
3524709;Jaguariúna;2020;94;1,7;92;1,7;2;0,0
3545001;Salesópolis;2020;19;1,1;17;1,0;2;0,1
3552304;Sud Mennucci;2020;22;2,9;20;2,6;2;0,3
3553609;Tapiratiba;2020;14;1,1;12;1,0;2;0,2
3555802;Urânia;2020;26;3,0;24;2,8;2;0,2
3510708;Cardoso;2020;31;2,6;12;1,0;19;1,6
3522802;Itaporanga;2020;46;3,1;27;1,8;19;1,3
3531506;Monte Azul Paulista;2020;70;3,8;51;2,8;19;1,0
3535507;Paraguaçu Paulista;2020;97;2,2;78;1,8;19;0,4
3538808;Piraju;2020;70;2,4;51;1,8;19;0,7
3540606;Porto Feliz;2020;60;1,2;41;0,8;19;0,4
3546801;Santa Isabel;2020;101;1,8;82;1,5;19;0,3
3547700;Santo Anastácio;2020;56;2,8;37;1,8;19;0,9
3552601;Tabapuã;2020;30;2,5;11;0,9;19;1,6
3556404;Vargem Grande do Sul;2020;58;1,4;39;0,9;19;0,5
3508108;Buritama;2020;36;2,2;18;1,1;18;1,1
3516606;Gália;2020;45;6,9;27;4,1;18;2,7
3517406;Guaíra;2020;61;1,6;43;1,1;18;0,5
3519402;Ibirá;2020;27;2,2;9;0,7;18;1,5
3521903;Itajobi;2020;50;3,4;32;2,2;18;1,2
3526407;Laranjal Paulista;2020;46;1,7;28;1,0;18;0,6
3539509;Pitangueiras;2020;50;1,3;32;0,8;18;0,5
3553807;Taquarituba;2020;49;2,1;31;1,3;18;0,8
3555406;Ubatuba;2020;130;1,5;112;1,3;18;0,2
3512001;Colina;2020;47;2,7;35;2,0;12;0,7
3525201;Jarinu;2020;29;1,0;17;0,6;12;0,4
3536307;Patrocínio Paulista;2020;35;2,4;23;1,6;12;0,8
3545407;Salto Grande;2020;34;3,7;22;2,4;12;1,3
3550407;São Pedro;2020;62;1,8;50;1,5;12;0,4
3528809;Maracaí;2020;26;1,9;22;1,6;4;0,3
3540804;Potirendaba;2020;31;1,9;27;1,6;4;0,2
3544004;Rio das Pedras;2020;36;1,0;32;0,9;4;0,1
3550803;São Sebastião da Grama;2020;30;2,5;26;2,2;4;0,3
3556503;Várzea Paulista;2020;35;0,3;31;0,3;4;0,0
3501103;Alto Alegre;2020;22;5,5;19;4,7;3;0,7
3502200;Angatuba;2020;57;2,3;54;2,2;3;0,1
3511904;Clementina;2020;24;2,9;21;2,5;3;0,4
3528106;Macaubal;2020;18;2,3;15;1,9;3;0,4
3539400;Piratininga;2020;28;2,1;25;1,9;3;0,2
3543808;Rinópolis;2020;23;2,4;20;2,1;3;0,3
3550100;São Manuel;2020;26;0,7;23;0,6;3;0,1
3503406;Arealva;2020;29;3,5;18;2,2;11;1,3
3508801;Cafelândia;2020;48;2,8;37;2,1;11;0,6
3532504;Neves Paulista;2020;21;2,4;10;1,2;11;1,3
3540408;Populina;2020;18;4,5;7;1,8;11;2,8
3541208;Presidente Bernardes;2020;51;3,7;40;2,9;11;0,8
3528007;Macatuba;2020;31;1,8;18;1,1;13;0,8
3546603;Santa Fé do Sul;2020;80;2,6;67;2,2;13;0,4
3547601;Santa Rosa de Viterbo;2020;32;1,2;19;0,7;13;0,5
3551504;Serrana;2020;125;2,8;112;2,5;13;0,3
3529708;Miguelópolis;2020;89;4,2;68;3,2;21;1,0
3516903;General Salgado;2020;28;2,6;19;1,8;9;0,8
3531803;Monte Mor;2020;35;0,6;26;0,4;9;0,2
3531902;Morro Agudo;2020;32;1,0;23;0,7;9;0,3
3537008;Pedregulho;2020;64;3,9;55;3,4;9;0,6
3542404;Regente Feijó;2020;35;1,8;26;1,3;9;0,5
3550001;São Luiz do Paraitinga;2020;25;2,4;16;1,5;9;0,9
3513702;Descalvado;2020;68;2,1;48;1,5;20;0,6
3514106;Dois Córregos;2020;67;2,5;47;1,7;20;0,7
3520905;Ipaussu;2020;49;3,4;29;2,0;20;1,4
3537800;Piedade;2020;79;1,5;59;1,1;20;0,4
3513603;Cunha;2020;40;1,8;25;1,2;15;0,7
3525003;Jandira;2020;25;0,2;10;0,1;15;0,1
3500105;Adamantina;2020;235;6,9;206;6,1;29;0,9
3500709;Agudos;2020;55;1,5;39;1,1;16;0,4
3501608;Americana;2020;508;2,2;196;0,8;312;1,3
3501905;Amparo;2020;392;5,6;215;3,1;177;2,5
3502101;Andradina;2020;102;1,8;69;1,2;33;0,6
3502507;Aparecida;2020;106;3,0;73;2,0;33;0,9
3502606;Aparecida d'Oeste;2020;14;3,4;13;3,1;1;0,2
3502804;Araçatuba;2020;412;2,2;248;1,3;164;0,9
3502903;Araçoiaba da Serra;2020;325;10,0;4;0,1;321;9,9
3503208;Araraquara;2020;454;2,0;254;1,1;200;0,9
3503307;Araras;2020;499;3,8;252;1,9;247;1,9
3503802;Artur Nogueira;2020;36;0,7;0;0,0;36;0,7
3504008;Assis;2020;278;2,7;153;1,5;125;1,2
3504107;Atibaia;2020;192;1,4;55;0,4;137;1,0
3504503;Avaré;2020;159;1,8;95;1,1;64;0,7
3505203;Bariri;2020;51;1,5;34;1,0;17;0,5
3505302;Barra Bonita;2020;91;2,6;59;1,7;32;0,9
3505500;Barretos;2020;503;4,3;391;3,3;112;0,9
3505708;Barueri;2020;496;1,9;420;1,6;76;0,3
3505906;Batatais;2020;133;2,2;101;1,7;32;0,5
3506003;Bauru;2020;1.268;3,5;676;1,9;592;1,6
3506102;Bebedouro;2020;153;2,1;88;1,2;65;0,9
3506409;Bilac;2020;36;4,6;35;4,5;1;0,1
3506508;Birigui;2020;146;1,2;66;0,5;80;0,7
3506706;Boa Esperança do Sul;2020;11;0,8;10;0,7;1;0,1
3507506;Botucatu;2020;714;5,1;541;3,8;173;1,2
3507605;Bragança Paulista;2020;402;2,5;221;1,3;181;1,1
3508504;Caçapava;2020;176;1,9;60;0,7;116;1,3
3509007;Caieiras;2020;129;1,3;85;0,8;44;0,4
3509205;Cajamar;2020;125;1,6;25;0,3;100;1,3
3509403;Cajuru;2020;140;5,5;55;2,1;85;3,3
3509502;Campinas;2020;2.696;2,3;1.357;1,2;1.339;1,1
3510302;Capela do Alto;2020;59;2,9;14;0,7;45;2,2
3510401;Capivari;2020;108;2,0;59;1,1;49;0,9
3510500;Caraguatatuba;2020;257;2,2;203;1,7;54;0,5
3510609;Carapicuíba;2020;270;0,7;220;0,6;50;0,1
3510807;Casa Branca;2020;372;12,6;356;12,1;16;0,5
3511102;Catanduva;2020;600;5,1;374;3,2;226;1,9
3511300;Cedral;2020;50;5,7;0;0,0;50;5,7
3512803;Cosmópolis;2020;71;1,0;31;0,4;40;0,6
3513009;Cotia;2020;519;2,1;159;0,6;360;1,5
3513405;Cruzeiro;2020;143;1,8;112;1,4;31;0,4
3513504;Cubatão;2020;133;1,0;106;0,8;27;0,2
3513801;Diadema;2020;642;1,6;573;1,4;69;0,2
3514403;Dracena;2020;143;3,2;108;2,4;35;0,8
3515004;Embu das Artes;2020;244;0,9;89;0,3;155;0,6
3515186;Espírito Santo do Pinhal;2020;453;10,6;354;8,3;99;2,3
3515509;Fernandópolis;2020;135;2,0;84;1,3;51;0,8
3516200;Franca;2020;729;2,1;542;1,6;187;0,5
3516408;Franco da Rocha;2020;661;4,3;611;4,0;50;0,3
3516705;Garça;2020;280;6,6;251;5,9;29;0,7
3518206;Guararapes;2020;74;2,3;48;1,5;26;0,8
3518404;Guaratinguetá;2020;269;2,3;122;1,0;147;1,2
3518701;Guarujá;2020;435;1,4;332;1,0;103;0,3
3518800;Guarulhos;2020;1.995;1,5;1.496;1,1;499;0,4
3519071;Hortolândia;2020;100;0,4;78;0,3;22;0,1
3519600;Ibitinga;2020;103;1,8;46;0,8;57;1,0
3519709;Ibiúna;2020;201;2,6;57;0,7;144;1,9
3520442;Ilha Solteira;2020;110;4,3;74;2,9;36;1,4
3520509;Indaiatuba;2020;350;1,4;207;0,9;143;0,6
3520707;Indiaporã;2020;36;9,3;4;1,0;32;8,3
3522208;Itapecerica da Serra;2020;589;3,5;182;1,1;407;2,4
3522307;Itapetininga;2020;152;0,9;110;0,7;42;0,3
3522406;Itapeva;2020;134;1,5;93;1,0;41;0,4
3522505;Itapevi;2020;334;1,4;245;1,0;89;0,4
3522604;Itapira;2020;1.093;15,3;592;8,3;501;7,0
3522703;Itápolis;2020;65;1,6;35;0,8;30;0,7
3523404;Itatiba;2020;120;1,0;70;0,6;50;0,4
3524006;Itupeva;2020;74;1,3;36;0,6;38;0,6
3524105;Ituverava;2020;120;3,0;53;1,3;67;1,7
3524303;Jaboticabal;2020;212;2,9;56;0,8;156;2,1
3524402;Jacareí;2020;377;1,7;181;0,8;196;0,9
3524501;Jaci;2020;216;31,0;149;21,4;67;9,6
3524808;Jales;2020;151;3,2;103;2,2;48;1,0
3525300;Jaú;2020;895;6,1;671;4,5;224;1,5
3525706;José Bonifácio;2020;53;1,5;22;0,6;31;0,9
3525904;Jundiaí;2020;813;2,0;429;1,1;384;0,9
3526001;Junqueirópolis;2020;52;2,6;25;1,2;27;1,3
3526704;Leme;2020;122;1,2;77;0,8;45;0,4
3526803;Lençóis Paulista;2020;88;1,3;45;0,7;43;0,6
3526902;Limeira;2020;384;1,3;208;0,7;176;0,6
3527108;Lins;2020;444;5,9;336;4,5;108;1,4
3527207;Lorena;2020;170;2,0;85;1,0;85;1,0
3529005;Marília;2020;867;3,7;660;2,9;207;0,9
3529302;Matão;2020;182;2,3;116;1,4;66;0,8
3529401;Mauá;2020;432;0,9;219;0,5;213;0,5
3530508;Mococa;2020;125;1,9;78;1,2;47;0,7
3530607;Mogi das Cruzes;2020;926;2,1;630;1,5;296;0,7
3530706;Mogi Guaçu;2020;372;2,5;180;1,2;192;1,3
3530805;Mogi Mirim;2020;196;2,2;131;1,4;65;0,7
3531308;Monte Alto;2020;109;2,3;58;1,2;51;1,1
3532603;Nhandeara;2020;129;12,0;35;3,2;94;8,7
3533007;Nova Granada;2020;62;3,0;19;0,9;43;2,1
3533502;Novo Horizonte;2020;105;2,7;35;0,9;70;1,8
3533908;Olímpia;2020;79;1,5;41;0,8;38;0,7
3534302;Orlândia;2020;118;2,8;72;1,7;46;1,1
3534401;Osasco;2020;926;1,4;626;0,9;300;0,4
3534609;Osvaldo Cruz;2020;71;2,3;47;1,5;24;0,8
3534708;Ourinhos;2020;204;1,8;133;1,2;71;0,6
3535309;Palmital;2020;41;1,9;27;1,3;14;0,6
3538006;Pindamonhangaba;2020;274;1,7;147;0,9;127;0,8
3538709;Piracicaba;2020;680;1,7;322;0,8;358;0,9
3538907;Pirajuí;2020;285;12,3;84;3,6;201;8,6
3539004;Pirangi;2020;41;3,8;9;0,8;32;3,0
3539301;Pirassununga;2020;173;2,3;57;0,8;116;1,6
3540200;Pontal;2020;54;1,1;38;0,8;16;0,3
3540705;Porto Ferreira;2020;55;1,0;33;0,6;22;0,4
3541000;Praia Grande;2020;427;1,3;294;0,9;133;0,4
3541406;Presidente Prudente;2020;1.117;5,1;683;3,1;434;2,0
3541505;Presidente Venceslau;2020;96;2,5;60;1,6;36;0,9
3542206;Rancharia;2020;103;3,6;71;2,5;32;1,1
3542602;Registro;2020;197;3,6;159;2,9;38;0,7
3543303;Ribeirão Pires;2020;188;1,6;74;0,6;114;1,0
3543402;Ribeirão Preto;2020;2.194;3,2;1.417;2,1;777;1,1
3543907;Rio Claro;2020;401;2,0;198;1,0;203;1,0
3544202;Riolândia;2020;36;3,1;7;0,6;29;2,5
3544301;Roseira;2020;54;5,1;14;1,3;40;3,8
3545209;Salto;2020;145;1,3;101;0,9;44;0,4
3545605;Santa Adélia;2020;24;1,6;7;0,5;17;1,1
3545803;Santa Bárbara d'Oeste;2020;165;0,9;122;0,6;43;0,2
3546405;Santa Cruz do Rio Pardo;2020;96;2,1;55;1,2;41;0,9
3547502;Santa Rita do Passa Quatro;2020;314;11,9;291;11,0;23;0,9
3547809;Santo André;2020;1.903;2,7;1.068;1,5;835;1,2
3548500;Santos;2020;1.854;4,3;975;2,3;879;2,1
3548609;São Bento do Sapucaí;2020;40;3,8;26;2,5;14;1,3
3548708;São Bernardo do Campo;2020;1.926;2,4;839;1,0;1.087;1,3
3548807;São Caetano do Sul;2020;741;4,9;177;1,2;564;3,7
3548906;São Carlos;2020;487;2,0;262;1,1;225;0,9
3549102;São João da Boa Vista;2020;199;2,3;94;1,1;105;1,2
3549409;São Joaquim da Barra;2020;115;2,3;68;1,4;47;0,9
3549706;São José do Rio Pardo;2020;127;2,4;76;1,4;51;1,0
3549805;São José do Rio Preto;2020;2.099;4,7;921;2,1;1.178;2,6
3549904;São José dos Campos;2020;1.595;2,2;728;1,0;867;1,2
3550308;São Paulo;2020;29.025;2,4;15.431;1,3;13.594;1,1
3550605;São Roque;2020;127;1,5;73;0,8;54;0,6
3551009;São Vicente;2020;248;0,7;152;0,4;96;0,3
3551603;Serra Negra;2020;49;1,8;33;1,2;16;0,6
3551702;Sertãozinho;2020;136;1,1;62;0,5;74;0,6
3552205;Sorocaba;2020;1.424;2,2;859;1,3;565;0,9
3552502;Suzano;2020;147;0,5;69;0,2;78;0,3
3552809;Taboão da Serra;2020;537;1,9;376;1,3;161;0,6
3553708;Taquaritinga;2020;124;2,3;72;1,3;52;1,0
3554003;Tatuí;2020;105;0,9;59;0,5;46;0,4
3554102;Taubaté;2020;553;1,8;379;1,2;174;0,6
3554508;Tietê;2020;55;1,3;33;0,8;22;0,5
3555000;Tupã;2020;346;5,5;330;5,3;16;0,3
3556008;Urupês;2020;34;2,6;11;0,8;23;1,7
3556206;Valinhos;2020;142;1,1;57;0,5;85;0,7
3556305;Valparaíso;2020;55;2,3;31;1,3;24;1,0
3556453;Vargem Grande Paulista;2020;70;1,3;2;0,0;68;1,3
3556602;Vera Cruz;2020;72;6,8;0;0,0;72;6,8
3556701;Vinhedo;2020;85;1,1;62;0,8;23;0,3
3557006;Votorantim;2020;237;2,0;78;0,7;159;1,3
3557105;Votuporanga;2020;205;2,2;115;1,3;90;1,0
3503901;Arujá;2020;98;1,1;30;0,3;68;0,8
3511003;Castilho;2020;31;1,5;30;1,4;1;0,0
3516002;Flórida Paulista;2020;47;3,9;30;2,5;17;1,4
3527306;Louveira;2020;36;0,7;30;0,6;6;0,1
3530300;Mirassol;2020;81;1,4;30;0,5;51;0,9
3531407;Monte Aprazível;2020;80;3,4;30;1,3;50;2,1
3553401;Tanabi;2020;72;2,9;30;1,2;42;1,7
3554409;Terra Roxa;2020;34;3,7;30;3,3;4;0,4
3555109;Tupi Paulista;2020;48;3,2;30;2,0;18;1,2
3556800;Viradouro;2020;48;2,6;30;1,6;18;1,0
3557204;Chavantes;2020;50;4,1;30;2,5;20;1,6
3500204;Adolfo;2019;0;0,0;0;0,0;0;0,0
3500303;Aguaí;2019;0;0,0;0;0,0;0;0,0
3500402;Águas da Prata;2019;0;0,0;0;0,0;0;0,0
3500550;Águas de Santa Bárbara;2019;0;0,0;0;0,0;0;0,0
3500600;Águas de São Pedro;2019;0;0,0;0;0,0;0;0,0
3500758;Alambari;2019;0;0,0;0;0,0;0;0,0
3500808;Alfredo Marcondes;2019;0;0,0;0;0,0;0;0,0
3500907;Altair;2019;0;0,0;0;0,0;0;0,0
3501152;Alumínio;2019;0;0,0;0;0,0;0;0,0
3501202;Álvares Florence;2019;0;0,0;0;0,0;0;0,0
3501400;Álvaro de Carvalho;2019;0;0,0;0;0,0;0;0,0
3501509;Alvinlândia;2019;0;0,0;0;0,0;0;0,0
3501806;Américo de Campos;2019;0;0,0;0;0,0;0;0,0
3502002;Analândia;2019;0;0,0;0;0,0;0;0,0
3502309;Anhembi;2019;0;0,0;0;0,0;0;0,0
3502408;Anhumas;2019;0;0,0;0;0,0;0;0,0
3502754;Araçariguama;2019;0;0,0;0;0,0;0;0,0
3503000;Aramina;2019;0;0,0;0;0,0;0;0,0
3503158;Arapeí;2019;0;0,0;0;0,0;0;0,0
3503356;Arco-Íris;2019;0;0,0;0;0,0;0;0,0
3503505;Areias;2019;0;0,0;0;0,0;0;0,0
3503604;Areiópolis;2019;0;0,0;0;0,0;0;0,0
3503703;Ariranha;2019;0;0,0;0;0,0;0;0,0
3503950;Aspásia;2019;0;0,0;0;0,0;0;0,0
3504305;Avaí;2019;0;0,0;0;0,0;0;0,0
3504404;Avanhandava;2019;0;0,0;0;0,0;0;0,0
3504602;Bady Bassitt;2019;0;0,0;0;0,0;0;0,0
3504701;Balbinos;2019;0;0,0;0;0,0;0;0,0
3504800;Bálsamo;2019;0;0,0;0;0,0;0;0,0
3505005;Barão de Antonina;2019;0;0,0;0;0,0;0;0,0
3505104;Barbosa;2019;0;0,0;0;0,0;0;0,0
3505351;Barra do Chapéu;2019;0;0,0;0;0,0;0;0,0
3505401;Barra do Turvo;2019;0;0,0;0;0,0;0;0,0
3505609;Barrinha;2019;0;0,0;0;0,0;0;0,0
3506201;Bento de Abreu;2019;0;0,0;0;0,0;0;0,0
3506607;Biritiba Mirim;2019;0;0,0;0;0,0;0;0,0
3506904;Bofete;2019;0;0,0;0;0,0;0;0,0
3507159;Bom Sucesso de Itararé;2019;0;0,0;0;0,0;0;0,0
3507209;Borá;2019;0;0,0;0;0,0;0;0,0
3507308;Boracéia;2019;0;0,0;0;0,0;0;0,0
3507456;Borebi;2019;0;0,0;0;0,0;0;0,0
3507704;Braúna;2019;0;0,0;0;0,0;0;0,0
3507753;Brejo Alegre;2019;0;0,0;0;0,0;0;0,0
3507803;Brodowski;2019;0;0,0;0;0,0;0;0,0
3508009;Buri;2019;0;0,0;0;0,0;0;0,0
3508207;Buritizal;2019;0;0,0;0;0,0;0;0,0
3508306;Cabrália Paulista;2019;0;0,0;0;0,0;0;0,0
3508900;Caiabu;2019;0;0,0;0;0,0;0;0,0
3509106;Caiuá;2019;0;0,0;0;0,0;0;0,0
3509254;Cajati;2019;0;0,0;0;0,0;0;0,0
3509452;Campina do Monte Alegre;2019;0;0,0;0;0,0;0;0,0
3509809;Campos Novos Paulista;2019;0;0,0;0;0,0;0;0,0
3509908;Cananéia;2019;0;0,0;0;0,0;0;0,0
3509957;Canas;2019;0;0,0;0;0,0;0;0,0
3510104;Cândido Rodrigues;2019;0;0,0;0;0,0;0;0,0
3510153;Canitar;2019;0;0,0;0;0,0;0;0,0
3510906;Cássia dos Coqueiros;2019;0;0,0;0;0,0;0;0,0
3511201;Catiguá;2019;0;0,0;0;0,0;0;0,0
3512407;Cordeirópolis;2019;0;0,0;0;0,0;0;0,0
3512506;Coroados;2019;0;0,0;0;0,0;0;0,0
3512704;Corumbataí;2019;0;0,0;0;0,0;0;0,0
3512902;Cosmorama;2019;0;0,0;0;0,0;0;0,0
3513207;Cristais Paulista;2019;0;0,0;0;0,0;0;0,0
3513306;Cruzália;2019;0;0,0;0;0,0;0;0,0
3513850;Dirce Reis;2019;0;0,0;0;0,0;0;0,0
3514007;Dobrada;2019;0;0,0;0;0,0;0;0,0
3514205;Dolcinópolis;2019;0;0,0;0;0,0;0;0,0
3514601;Dumont;2019;0;0,0;0;0,0;0;0,0
3514700;Echaporã;2019;0;0,0;0;0,0;0;0,0
3514924;Elisiário;2019;0;0,0;0;0,0;0;0,0
3514957;Embaúba;2019;0;0,0;0;0,0;0;0,0
3515129;Emilianópolis;2019;0;0,0;0;0,0;0;0,0
3515152;Engenheiro Coelho;2019;0;0,0;0;0,0;0;0,0
3515194;Espírito Santo do Turvo;2019;0;0,0;0;0,0;0;0,0
3515301;Estrela do Norte;2019;0;0,0;0;0,0;0;0,0
3515350;Euclides da Cunha Paulista;2019;0;0,0;0;0,0;0;0,0
3515608;Fernando Prestes;2019;0;0,0;0;0,0;0;0,0
3515657;Fernão;2019;0;0,0;0;0,0;0;0,0
3515806;Flora Rica;2019;0;0,0;0;0,0;0;0,0
3515905;Floreal;2019;0;0,0;0;0,0;0;0,0
3516101;Florínea;2019;0;0,0;0;0,0;0;0,0
3516507;Gabriel Monteiro;2019;0;0,0;0;0,0;0;0,0
3516804;Gastão Vidigal;2019;0;0,0;0;0,0;0;0,0
3516853;Gavião Peixoto;2019;0;0,0;0;0,0;0;0,0
3517109;Glicério;2019;0;0,0;0;0,0;0;0,0
3517208;Guaiçara;2019;0;0,0;0;0,0;0;0,0
3517307;Guaimbê;2019;0;0,0;0;0,0;0;0,0
3517505;Guapiaçu;2019;0;0,0;0;0,0;0;0,0
3517901;Guaraci;2019;0;0,0;0;0,0;0;0,0
3518008;Guarani d'Oeste;2019;0;0,0;0;0,0;0;0,0
3518107;Guarantã;2019;0;0,0;0;0,0;0;0,0
3518503;Guareí;2019;0;0,0;0;0,0;0;0,0
3518859;Guatapará;2019;0;0,0;0;0,0;0;0,0
3518909;Guzolândia;2019;0;0,0;0;0,0;0;0,0
3519055;Holambra;2019;0;0,0;0;0,0;0;0,0
3519204;Iacri;2019;0;0,0;0;0,0;0;0,0
3519253;Iaras;2019;0;0,0;0;0,0;0;0,0
3519501;Ibirarema;2019;0;0,0;0;0,0;0;0,0
3519808;Icém;2019;0;0,0;0;0,0;0;0,0
3520004;Igaraçu do Tietê;2019;0;0,0;0;0,0;0;0,0
3520426;Ilha Comprida;2019;0;0,0;0;0,0;0;0,0
3520608;Indiana;2019;0;0,0;0;0,0;0;0,0
3520806;Inúbia Paulista;2019;0;0,0;0;0,0;0;0,0
3521101;Ipeúna;2019;0;0,0;0;0,0;0;0,0
3521150;Ipiguá;2019;0;0,0;0;0,0;0;0,0
3521200;Iporanga;2019;0;0,0;0;0,0;0;0,0
3521507;Irapuã;2019;0;0,0;0;0,0;0;0,0
3521606;Irapuru;2019;0;0,0;0;0,0;0;0,0
3522000;Itaju;2019;0;0,0;0;0,0;0;0,0
3522158;Itaoca;2019;0;0,0;0;0,0;0;0,0
3522653;Itapirapuã Paulista;2019;0;0,0;0;0,0;0;0,0
3523008;Itapura;2019;0;0,0;0;0,0;0;0,0
3523305;Itariri;2019;0;0,0;0;0,0;0;0,0
3523701;Itirapuã;2019;0;0,0;0;0,0;0;0,0
3523800;Itobi;2019;0;0,0;0;0,0;0;0,0
3524600;Jacupiranga;2019;0;0,0;0;0,0;0;0,0
3524907;Jambeiro;2019;0;0,0;0;0,0;0;0,0
3525102;Jardinópolis;2019;0;0,0;0;0,0;0;0,0
3525409;Jeriquara;2019;0;0,0;0;0,0;0;0,0
3525607;João Ramalho;2019;0;0,0;0;0,0;0;0,0
3525805;Júlio Mesquita;2019;0;0,0;0;0,0;0;0,0
3525854;Jumirim;2019;0;0,0;0;0,0;0;0,0
3526100;Juquiá;2019;0;0,0;0;0,0;0;0,0
3526308;Lagoinha;2019;0;0,0;0;0,0;0;0,0
3526506;Lavínia;2019;0;0,0;0;0,0;0;0,0
3526605;Lavrinhas;2019;0;0,0;0;0,0;0;0,0
3527009;Lindóia;2019;0;0,0;0;0,0;0;0,0
3527256;Lourdes;2019;0;0,0;0;0,0;0;0,0
3527504;Lucianópolis;2019;0;0,0;0;0,0;0;0,0
3527603;Luís Antônio;2019;0;0,0;0;0,0;0;0,0
3527801;Lupércio;2019;0;0,0;0;0,0;0;0,0
3527900;Lutécia;2019;0;0,0;0;0,0;0;0,0
3528205;Macedônia;2019;0;0,0;0;0,0;0;0,0
3528304;Magda;2019;0;0,0;0;0,0;0;0,0
3528403;Mairinque;2019;0;0,0;0;0,0;0;0,0
3528601;Manduri;2019;0;0,0;0;0,0;0;0,0
3528700;Marabá Paulista;2019;0;0,0;0;0,0;0;0,0
3528858;Marapoama;2019;0;0,0;0;0,0;0;0,0
3528908;Mariápolis;2019;0;0,0;0;0,0;0;0,0
3529104;Marinópolis;2019;0;0,0;0;0,0;0;0,0
3529500;Mendonça;2019;0;0,0;0;0,0;0;0,0
3529609;Meridiano;2019;0;0,0;0;0,0;0;0,0
3529658;Mesópolis;2019;0;0,0;0;0,0;0;0,0
3529906;Miracatu;2019;0;0,0;0;0,0;0;0,0
3530003;Mira Estrela;2019;0;0,0;0;0,0;0;0,0
3530201;Mirante do Paranapanema;2019;0;0,0;0;0,0;0;0,0
3530409;Mirassolândia;2019;0;0,0;0;0,0;0;0,0
3530904;Mombuca;2019;0;0,0;0;0,0;0;0,0
3531001;Monções;2019;0;0,0;0;0,0;0;0,0
3531209;Monte Alegre do Sul;2019;0;0,0;0;0,0;0;0,0
3531605;Monte Castelo;2019;0;0,0;0;0,0;0;0,0
3531704;Monteiro Lobato;2019;0;0,0;0;0,0;0;0,0
3532058;Motuca;2019;0;0,0;0;0,0;0;0,0
3532108;Murutinga do Sul;2019;0;0,0;0;0,0;0;0,0
3532157;Nantes;2019;0;0,0;0;0,0;0;0,0
3532207;Narandiba;2019;0;0,0;0;0,0;0;0,0
3532306;Natividade da Serra;2019;0;0,0;0;0,0;0;0,0
3532702;Nipoã;2019;0;0,0;0;0,0;0;0,0
3532801;Nova Aliança;2019;0;0,0;0;0,0;0;0,0
3532827;Nova Campina;2019;0;0,0;0;0,0;0;0,0
3532843;Nova Canaã Paulista;2019;0;0,0;0;0,0;0;0,0
3532868;Nova Castilho;2019;0;0,0;0;0,0;0;0,0
3533106;Nova Guataporanga;2019;0;0,0;0;0,0;0;0,0
3533205;Nova Independência;2019;0;0,0;0;0,0;0;0,0
3533254;Novais;2019;0;0,0;0;0,0;0;0,0
3533304;Nova Luzitânia;2019;0;0,0;0;0,0;0;0,0
3533601;Nuporanga;2019;0;0,0;0;0,0;0;0,0
3533700;Ocauçu;2019;0;0,0;0;0,0;0;0,0
3533809;Óleo;2019;0;0,0;0;0,0;0;0,0
3534005;Onda Verde;2019;0;0,0;0;0,0;0;0,0
3534104;Oriente;2019;0;0,0;0;0,0;0;0,0
3534203;Orindiúva;2019;0;0,0;0;0,0;0;0,0
3534500;Oscar Bressane;2019;0;0,0;0;0,0;0;0,0
3534807;Ouro Verde;2019;0;0,0;0;0,0;0;0,0
3535002;Palestina;2019;0;0,0;0;0,0;0;0,0
3535101;Palmares Paulista;2019;0;0,0;0;0,0;0;0,0
3535606;Paraibuna;2019;0;0,0;0;0,0;0;0,0
3535705;Paraíso;2019;0;0,0;0;0,0;0;0,0
3535903;Paranapuã;2019;0;0,0;0;0,0;0;0,0
3536109;Pardinho;2019;0;0,0;0;0,0;0;0,0
3536257;Parisi;2019;0;0,0;0;0,0;0;0,0
3536406;Paulicéia;2019;0;0,0;0;0,0;0;0,0
3536570;Paulistânia;2019;0;0,0;0;0,0;0;0,0
3536802;Pedra Bela;2019;0;0,0;0;0,0;0;0,0
3536901;Pedranópolis;2019;0;0,0;0;0,0;0;0,0
3537156;Pedrinhas Paulista;2019;0;0,0;0;0,0;0;0,0
3537206;Pedro de Toledo;2019;0;0,0;0;0,0;0;0,0
3537503;Pereiras;2019;0;0,0;0;0,0;0;0,0
3537701;Piacatu;2019;0;0,0;0;0,0;0;0,0
3538105;Pindorama;2019;0;0,0;0;0,0;0;0,0
3538204;Pinhalzinho;2019;0;0,0;0;0,0;0;0,0
3538303;Piquerobi;2019;0;0,0;0;0,0;0;0,0
3538501;Piquete;2019;0;0,0;0;0,0;0;0,0
3539103;Pirapora do Bom Jesus;2019;0;0,0;0;0,0;0;0,0
3539202;Pirapozinho;2019;0;0,0;0;0,0;0;0,0
3539608;Planalto;2019;0;0,0;0;0,0;0;0,0
3539707;Platina;2019;0;0,0;0;0,0;0;0,0
3539905;Poloni;2019;0;0,0;0;0,0;0;0,0
3540101;Pongaí;2019;0;0,0;0;0,0;0;0,0
3540259;Pontalinda;2019;0;0,0;0;0,0;0;0,0
3540309;Pontes Gestal;2019;0;0,0;0;0,0;0;0,0
3540507;Porangaba;2019;0;0,0;0;0,0;0;0,0
3540754;Potim;2019;0;0,0;0;0,0;0;0,0
3540853;Pracinha;2019;0;0,0;0;0,0;0;0,0
3540903;Pradópolis;2019;0;0,0;0;0,0;0;0,0
3541059;Pratânia;2019;0;0,0;0;0,0;0;0,0
3541109;Presidente Alves;2019;0;0,0;0;0,0;0;0,0
3541653;Quadra;2019;0;0,0;0;0,0;0;0,0
3541703;Quatá;2019;0;0,0;0;0,0;0;0,0
3541802;Queiroz;2019;0;0,0;0;0,0;0;0,0
3542008;Quintana;2019;0;0,0;0;0,0;0;0,0
3542107;Rafard;2019;0;0,0;0;0,0;0;0,0
3542305;Redenção da Serra;2019;0;0,0;0;0,0;0;0,0
3542503;Reginópolis;2019;0;0,0;0;0,0;0;0,0
3542701;Restinga;2019;0;0,0;0;0,0;0;0,0
3542800;Ribeira;2019;0;0,0;0;0,0;0;0,0
3543105;Ribeirão Corrente;2019;0;0,0;0;0,0;0;0,0
3543204;Ribeirão do Sul;2019;0;0,0;0;0,0;0;0,0
3543238;Ribeirão dos Índios;2019;0;0,0;0;0,0;0;0,0
3543253;Ribeirão Grande;2019;0;0,0;0;0,0;0;0,0
3543501;Riversul;2019;0;0,0;0;0,0;0;0,0
3543600;Rifaina;2019;0;0,0;0;0,0;0;0,0
3543709;Rincão;2019;0;0,0;0;0,0;0;0,0
3544103;Rio Grande da Serra;2019;0;0,0;0;0,0;0;0,0
3544400;Rubiácea;2019;0;0,0;0;0,0;0;0,0
3544509;Rubinéia;2019;0;0,0;0;0,0;0;0,0
3544608;Sabino;2019;0;0,0;0;0,0;0;0,0
3544707;Sagres;2019;0;0,0;0;0,0;0;0,0
3544806;Sales;2019;0;0,0;0;0,0;0;0,0
3545100;Salmourão;2019;0;0,0;0;0,0;0;0,0
3545159;Saltinho;2019;0;0,0;0;0,0;0;0,0
3545506;Sandovalina;2019;0;0,0;0;0,0;0;0,0
3545704;Santa Albertina;2019;0;0,0;0;0,0;0;0,0
3546009;Santa Branca;2019;0;0,0;0;0,0;0;0,0
3546108;Santa Clara d'Oeste;2019;0;0,0;0;0,0;0;0,0
3546207;Santa Cruz da Conceição;2019;0;0,0;0;0,0;0;0,0
3546256;Santa Cruz da Esperança;2019;0;0,0;0;0,0;0;0,0
3546504;Santa Ernestina;2019;0;0,0;0;0,0;0;0,0
3546702;Santa Gertrudes;2019;0;0,0;0;0,0;0;0,0
3546900;Santa Lúcia;2019;0;0,0;0;0,0;0;0,0
3547106;Santa Mercedes;2019;0;0,0;0;0,0;0;0,0
3547205;Santana da Ponte Pensa;2019;0;0,0;0;0,0;0;0,0
3547403;Santa Rita d'Oeste;2019;0;0,0;0;0,0;0;0,0
3547650;Santa Salete;2019;0;0,0;0;0,0;0;0,0
3548005;Santo Antônio de Posse;2019;0;0,0;0;0,0;0;0,0
3548054;Santo Antônio do Aracanguá;2019;0;0,0;0;0,0;0;0,0
3548104;Santo Antônio do Jardim;2019;0;0,0;0;0,0;0;0,0
3548203;Santo Antônio do Pinhal;2019;0;0,0;0;0,0;0;0,0
3548302;Santo Expedito;2019;0;0,0;0;0,0;0;0,0
3548401;Santópolis do Aguapeí;2019;0;0,0;0;0,0;0;0,0
3549003;São Francisco;2019;0;0,0;0;0,0;0;0,0
3549201;São João das Duas Pontes;2019;0;0,0;0;0,0;0;0,0
3549250;São João de Iracema;2019;0;0,0;0;0,0;0;0,0
3549300;São João do Pau d'Alho;2019;0;0,0;0;0,0;0;0,0
3549508;São José da Bela Vista;2019;0;0,0;0;0,0;0;0,0
3549607;São José do Barreiro;2019;0;0,0;0;0,0;0;0,0
3549953;São Lourenço da Serra;2019;0;0,0;0;0,0;0;0,0
3550506;São Pedro do Turvo;2019;0;0,0;0;0,0;0;0,0
3551108;Sarapuí;2019;0;0,0;0;0,0;0;0,0
3551207;Sarutaiá;2019;0;0,0;0;0,0;0;0,0
3551306;Sebastianópolis do Sul;2019;0;0,0;0;0,0;0;0,0
3551405;Serra Azul;2019;0;0,0;0;0,0;0;0,0
3551801;Sete Barras;2019;0;0,0;0;0,0;0;0,0
3551900;Severínia;2019;0;0,0;0;0,0;0;0,0
3552551;Suzanápolis;2019;0;0,0;0;0,0;0;0,0
3552908;Taciba;2019;0;0,0;0;0,0;0;0,0
3553104;Taiaçu;2019;0;0,0;0;0,0;0;0,0
3553500;Tapiraí;2019;0;0,0;0;0,0;0;0,0
3553658;Taquaral;2019;0;0,0;0;0,0;0;0,0
3553856;Taquarivaí;2019;0;0,0;0;0,0;0;0,0
3553906;Tarabai;2019;0;0,0;0;0,0;0;0,0
3553955;Tarumã;2019;0;0,0;0;0,0;0;0,0
3554201;Tejupá;2019;0;0,0;0;0,0;0;0,0
3554607;Timburi;2019;0;0,0;0;0,0;0;0,0
3554656;Torre de Pedra;2019;0;0,0;0;0,0;0;0,0
3554755;Trabiju;2019;0;0,0;0;0,0;0;0,0
3554805;Tremembé;2019;0;0,0;0;0,0;0;0,0
3554904;Três Fronteiras;2019;0;0,0;0;0,0;0;0,0
3554953;Tuiuti;2019;0;0,0;0;0,0;0;0,0
3555208;Turiúba;2019;0;0,0;0;0,0;0;0,0
3555307;Turmalina;2019;0;0,0;0;0,0;0;0,0
3555356;Ubarana;2019;0;0,0;0;0,0;0;0,0
3555505;Ubirajara;2019;0;0,0;0;0,0;0;0,0
3555604;Uchoa;2019;0;0,0;0;0,0;0;0,0
3555703;União Paulista;2019;0;0,0;0;0,0;0;0,0
3555901;Uru;2019;0;0,0;0;0,0;0;0,0
3556107;Valentim Gentil;2019;0;0,0;0;0,0;0;0,0
3556354;Vargem;2019;0;0,0;0;0,0;0;0,0
3556909;Vista Alegre do Alto;2019;0;0,0;0;0,0;0;0,0
3556958;Vitória Brasil;2019;0;0,0;0;0,0;0;0,0
3557154;Zacarias;2019;0;0,0;0;0,0;0;0,0
3557303;Estiva Gerbi;2019;0;0,0;0;0,0;0;0,0
3501707;Américo Brasiliense;2019;177;4,5;177;4,5;0;0,0
3503109;Arandu;2019;12;1,9;12;1,9;0;0,0
3504909;Bananal;2019;15;1,4;15;1,4;0;0,0
3506300;Bernardino de Campos;2019;23;2,1;23;2,1;0;0,0
3506359;Bertioga;2019;49;0,8;49;0,8;0;0,0
3507100;Bom Jesus dos Perdões;2019;12;0,5;12;0,5;0;0,0
3508702;Caconde;2019;62;3,3;62;3,3;0;0,0
3509601;Campo Limpo Paulista;2019;68;0,8;68;0,8;0;0,0
3512100;Colômbia;2019;20;3,3;20;3,3;0;0,0
3512308;Conchas;2019;32;1,9;32;1,9;0;0,0
3512605;Coronel Macedo;2019;6;1,2;6;1,2;0;0,0
3513900;Divinolândia;2019;186;17,0;186;17,0;0;0,0
3514304;Dourado;2019;14;1,6;14;1,6;0;0,0
3514809;Eldorado;2019;2;0,1;2;0,1;0;0,0
3514908;Elias Fausto;2019;6;0,3;6;0,3;0;0,0
3515103;Embu-Guaçu;2019;17;0,3;17;0,3;0;0,0
3515707;Ferraz de Vasconcelos;2019;189;1,0;189;1,0;0;0,0
3516309;Francisco Morato;2019;98;0,6;98;0,6;0;0,0
3517604;Guapiara;2019;27;1,5;27;1,5;0;0,0
3519006;Herculândia;2019;58;6,3;58;6,3;0;0,0
3519303;Ibaté;2019;27;0,8;27;0,8;0;0,0
3519907;Iepê;2019;18;2,3;18;2,3;0;0,0
3520202;Igaratá;2019;8;0,9;8;0,9;0;0,0
3520301;Iguape;2019;9;0,3;9;0,3;0;0,0
3520400;Ilhabela;2019;51;1,5;51;1,5;0;0,0
3521002;Iperó;2019;15;0,4;15;0,4;0;0,0
3521408;Iracemápolis;2019;3;0,1;3;0,1;0;0,0
3521705;Itaberá;2019;19;1,1;19;1,1;0;0,0
3521804;Itaí;2019;35;1,3;35;1,3;0;0,0
3522109;Itanhaém;2019;131;1,3;131;1,3;0;0,0
3522901;Itapuí;2019;30;2,2;30;2,2;0;0,0
3523107;Itaquaquecetuba;2019;224;0,6;224;0,6;0;0,0
3523602;Itirapina;2019;25;1,5;25;1,5;0;0,0
3524204;Jaborandi;2019;17;2,5;17;2,5;0;0,0
3525508;Joanópolis;2019;11;0,9;11;0,9;0;0,0
3527702;Luiziânia;2019;3;0,5;3;0,5;0;0,0
3529807;Mineiros do Tietê;2019;11;0,9;11;0,9;0;0,0
3530102;Mirandópolis;2019;68;2,4;68;2,4;0;0,0
3531100;Mongaguá;2019;36;0,7;36;0,7;0;0,0
3532405;Nazaré Paulista;2019;20;1,1;20;1,1;0;0,0
3533403;Nova Odessa;2019;53;0,9;53;0,9;0;0,0
3535804;Paranapanema;2019;30;1,5;30;1,5;0;0,0
3536208;Pariquera-Açu;2019;150;7,8;150;7,8;0;0,0
3536505;Paulínia;2019;97;0,9;97;0,9;0;0,0
3537107;Pedreira;2019;98;2,1;98;2,1;0;0,0
3537602;Peruíbe;2019;14;0,2;14;0,2;0;0,0
3539806;Poá;2019;36;0,3;36;0,3;0;0,0
3541604;Promissão;2019;37;0,9;37;0,9;0;0,0
3541901;Queluz;2019;38;3,0;38;3,0;0;0,0
3544251;Rosana;2019;57;3,1;57;3,1;0;0,0
3547007;Santa Maria da Serra;2019;6;1,0;6;1,0;0;0,0
3547304;Santana de Parnaíba;2019;30;0,2;30;0,2;0;0,0
3547908;Santo Antônio da Alegria;2019;19;2,9;19;2,9;0;0,0
3550209;São Miguel Arcanjo;2019;50;1,6;50;1,6;0;0,0
3552007;Silveiras;2019;2;0,3;2;0,3;0;0,0
3553203;Taiúva;2019;4;0,6;4;0,6;0;0,0
3507407;Borborema;2019;26;1,7;16;1,0;10;0,7
3509700;Campos do Jordão;2019;201;4,0;191;3,8;10;0,2
3510203;Capão Bonito;2019;58;1,3;48;1,0;10;0,2
3511904;Clementina;2019;30;3,7;20;2,4;10;1,2
3512209;Conchal;2019;52;1,9;42;1,6;10;0,4
3514502;Duartina;2019;87;7,2;77;6,4;10;0,8
3517703;Guará;2019;50;2,4;40;1,9;10;0,5
3521309;Ipuã;2019;49;3,1;39;2,5;10;0,6
3532009;Morungaba;2019;19;1,5;9;0,7;10;0,8
3535200;Palmeira d'Oeste;2019;20;2,2;10;1,1;10;1,1
3537800;Piedade;2019;60;1,1;50;0,9;10;0,2
3541307;Presidente Epitácio;2019;78;1,8;68;1,6;10;0,2
3544905;Sales Oliveira;2019;30;2,6;20;1,7;10;0,9
3546306;Santa Cruz das Palmeiras;2019;35;1,0;25;0,7;10;0,3
3505807;Bastos;2019;35;1,7;28;1,4;7;0,3
3511409;Cerqueira César;2019;39;2,0;32;1,7;7;0,4
3511706;Charqueada;2019;33;2,0;26;1,6;7;0,4
3518602;Guariba;2019;66;1,7;59;1,5;7;0,2
3523503;Itatinga;2019;14;0,7;7;0,3;7;0,3
3552106;Socorro;2019;70;1,8;63;1,6;7;0,2
3554706;Torrinha;2019;20;2,1;13;1,3;7;0,7
3501004;Altinópolis;2019;31;2,0;25;1,6;6;0,4
3502705;Apiaí;2019;45;1,8;39;1,6;6;0,2
3506805;Bocaina;2019;35;2,9;29;2,4;6;0,5
3507902;Brotas;2019;41;1,7;35;1,5;6;0,3
3509304;Cajobi;2019;32;3,2;26;2,6;6;0,6
3518305;Guararema;2019;35;1,2;29;1,0;6;0,2
3528502;Mairiporã;2019;47;0,5;41;0,4;6;0,1
3536000;Parapuã;2019;32;3,0;26;2,5;6;0,6
3536604;Paulo de Faria;2019;24;2,8;18;2,1;6;0,7
3542909;Ribeirão Bonito;2019;17;1,3;11;0,9;6;0,5
3554300;Teodoro Sampaio;2019;58;2,6;52;2,3;6;0,3
3515400;Fartura;2019;20;1,3;12;0,8;8;0,5
3517802;Guaraçaí;2019;23;2,7;15;1,8;8;1,0
3537909;Pilar do Sul;2019;35;1,2;27;1,0;8;0,3
3538600;Piracaia;2019;37;1,4;29;1,1;8;0,3
3550704;São Sebastião;2019;101;1,2;93;1,1;8;0,1
3550902;São Simão;2019;40;2,7;32;2,2;8;0,5
3556503;Várzea Paulista;2019;39;0,3;31;0,3;8;0,1
3508405;Cabreúva;2019;15;0,3;10;0,2;5;0,1
3510005;Cândido Mota;2019;30;1,0;25;0,8;5;0,2
3511607;Cesário Lange;2019;22;1,3;17;1,0;5;0,3
3515202;Estrela d'Oeste;2019;66;8,1;61;7,5;5;0,6
3527306;Louveira;2019;36;0,8;31;0,7;5;0,1
3527405;Lucélia;2019;15;0,7;10;0,5;5;0,2
3532900;Nova Europa;2019;12;1,1;7;0,7;5;0,5
3534757;Ouroeste;2019;33;3,4;28;2,9;5;0,5
3534906;Pacaembu;2019;37;2,8;32;2,4;5;0,4
3537404;Pereira Barreto;2019;52;2,1;47;1,9;5;0,2
3540002;Pompéia;2019;19;0,9;14;0,7;5;0,2
3545308;Salto de Pirapora;2019;48;1,1;43;1,0;5;0,1
3552403;Sumaré;2019;177;0,6;172;0,6;5;0,0
3553005;Taguaí;2019;29;2,2;24;1,8;5;0,4
3501301;Álvares Machado;2019;20;0,8;18;0,8;2;0,1
3502606;Aparecida d'Oeste;2019;22;5,3;20;4,8;2;0,5
3508603;Cachoeira Paulista;2019;16;0,5;14;0,4;2;0,1
3513108;Cravinhos;2019;15;0,4;13;0,4;2;0,1
3519105;Iacanga;2019;30;2,7;28;2,5;2;0,2
3524709;Jaguariúna;2019;80;1,5;78;1,4;2;0,0
3545001;Salesópolis;2019;19;1,1;17;1,0;2;0,1
3552304;Sud Mennucci;2019;22;2,9;20;2,6;2;0,3
3555802;Urânia;2019;26;3,0;24;2,8;2;0,2
3510708;Cardoso;2019;31;2,6;12;1,0;19;1,6
3522802;Itaporanga;2019;46;3,1;27;1,8;19;1,3
3529708;Miguelópolis;2019;66;3,1;47;2,2;19;0,9
3531506;Monte Azul Paulista;2019;70;3,8;51;2,8;19;1,0
3535507;Paraguaçu Paulista;2019;97;2,2;78;1,8;19;0,4
3538808;Piraju;2019;77;2,7;58;2,0;19;0,7
3546801;Santa Isabel;2019;101;1,8;82;1,5;19;0,3
3547700;Santo Anastácio;2019;56;2,8;37;1,8;19;0,9
3552601;Tabapuã;2019;30;2,5;11;0,9;19;1,6
3556404;Vargem Grande do Sul;2019;50;1,2;31;0,8;19;0,5
3507001;Boituva;2019;54;1,0;36;0,6;18;0,3
3516606;Gália;2019;45;6,8;27;4,1;18;2,7
3517406;Guaíra;2019;60;1,5;42;1,1;18;0,5
3519402;Ibirá;2019;27;2,3;9;0,8;18;1,5
3520103;Igarapava;2019;60;2,0;42;1,4;18;0,6
3521903;Itajobi;2019;50;3,4;32;2,2;18;1,2
3526407;Laranjal Paulista;2019;46;1,7;28;1,0;18;0,7
3535309;Palmital;2019;54;2,5;36;1,7;18;0,8
3539509;Pitangueiras;2019;50;1,3;32;0,8;18;0,5
3553807;Taquarituba;2019;49;2,1;31;1,3;18;0,8
3555406;Ubatuba;2019;92;1,0;74;0,8;18;0,2
3512001;Colina;2019;47;2,7;35;2,0;12;0,7
3516903;General Salgado;2019;32;3,0;20;1,9;12;1,1
3517000;Getulina;2019;48;4,4;36;3,3;12;1,1
3525201;Jarinu;2019;29;1,0;17;0,6;12;0,4
3536307;Patrocínio Paulista;2019;35;2,4;23;1,6;12;0,8
3540606;Porto Feliz;2019;51;1,0;39;0,8;12;0,2
3545407;Salto Grande;2019;34;3,8;22;2,4;12;1,3
3528809;Maracaí;2019;26;1,9;22;1,6;4;0,3
3540804;Potirendaba;2019;31;1,9;27;1,6;4;0,2
3544004;Rio das Pedras;2019;36;1,1;32;0,9;4;0,1
3550100;São Manuel;2019;35;0,9;31;0,8;4;0,1
3550803;São Sebastião da Grama;2019;30;2,5;26;2,2;4;0,3
3501103;Alto Alegre;2019;22;5,5;19;4,7;3;0,7
3502200;Angatuba;2019;57;2,3;54;2,2;3;0,1
3528106;Macaubal;2019;18;2,3;15;1,9;3;0,4
3539400;Piratininga;2019;28;2,1;25;1,9;3;0,2
3542404;Regente Feijó;2019;16;0,8;13;0,7;3;0,2
3543808;Rinópolis;2019;23;2,4;20;2,1;3;0,3
3553609;Tapiratiba;2019;16;1,3;13;1,0;3;0,2
3503406;Arealva;2019;29;3,6;18;2,2;11;1,3
3508801;Cafelândia;2019;48;2,8;37;2,2;11;0,6
3511508;Cerquilho;2019;32;0,7;21;0,5;11;0,2
3532504;Neves Paulista;2019;21;2,4;10;1,2;11;1,3
3540408;Populina;2019;18;4,5;7;1,7;11;2,7
3541208;Presidente Bernardes;2019;51;3,7;40;2,9;11;0,8
3547601;Santa Rosa de Viterbo;2019;32;1,3;21;0,8;11;0,4
3553302;Tambaú;2019;36;1,6;25;1,1;11;0,5
3528007;Macatuba;2019;31;1,8;18;1,1;13;0,8
3541000;Praia Grande;2019;212;0,7;199;0,6;13;0,0
3551504;Serrana;2019;125;2,8;112;2,6;13;0,3
3552700;Tabatinga;2019;35;2,2;22;1,4;13;0,8
3504206;Auriflama;2019;44;3,0;35;2,4;9;0,6
3531803;Monte Mor;2019;35;0,6;26;0,4;9;0,2
3537008;Pedregulho;2019;64;3,9;55;3,4;9;0,6
3550001;São Luiz do Paraitinga;2019;25;2,4;16;1,5;9;0,9
3508108;Buritama;2019;42;2,5;22;1,3;20;1,2
3514106;Dois Córregos;2019;67;2,5;47;1,8;20;0,7
3520905;Ipaussu;2019;49;3,4;29;2,0;20;1,4
3536703;Pederneiras;2019;72;1,6;52;1,2;20;0,4
3513603;Cunha;2019;40;1,8;25;1,2;15;0,7
3513702;Descalvado;2019;40;1,2;25;0,8;15;0,5
3525003;Jandira;2019;15;0,1;0;0,0;15;0,1
3500105;Adamantina;2019;235;6,9;206;6,1;29;0,9
3500709;Agudos;2019;60;1,7;38;1,1;22;0,6
3501608;Americana;2019;517;2,2;207;0,9;310;1,3
3501905;Amparo;2019;392;5,7;215;3,1;177;2,6
3502101;Andradina;2019;127;2,3;91;1,6;36;0,6
3502507;Aparecida;2019;104;2,9;70;2,0;34;1,0
3502804;Araçatuba;2019;435;2,3;305;1,6;130;0,7
3502903;Araçoiaba da Serra;2019;321;10,1;0;0,0;321;10,1
3503208;Araraquara;2019;442;2,0;222;1,0;220;1,0
3503307;Araras;2019;503;3,9;246;1,9;257;2,0
3503802;Artur Nogueira;2019;36;0,7;0;0,0;36;0,7
3503901;Arujá;2019;92;1,0;24;0,3;68;0,8
3504008;Assis;2019;285;2,8;160;1,6;125;1,2
3504107;Atibaia;2019;192;1,4;55;0,4;137;1,0
3504503;Avaré;2019;159;1,8;95;1,1;64;0,7
3505203;Bariri;2019;51;1,5;34;1,0;17;0,5
3505302;Barra Bonita;2019;91;2,6;59;1,7;32;0,9
3505500;Barretos;2019;504;4,3;391;3,3;113;1,0
3505708;Barueri;2019;431;1,6;355;1,4;76;0,3
3505906;Batatais;2019;133;2,2;101;1,7;32;0,5
3506003;Bauru;2019;1.228;3,4;636;1,8;592;1,6
3506102;Bebedouro;2019;140;1,9;75;1,0;65;0,9
3506409;Bilac;2019;36;4,6;35;4,5;1;0,1
3506508;Birigui;2019;146;1,2;66;0,5;80;0,7
3506706;Boa Esperança do Sul;2019;14;1,0;13;0,9;1;0,1
3507506;Botucatu;2019;644;4,6;541;3,9;103;0,7
3507605;Bragança Paulista;2019;372;2,3;206;1,3;166;1,0
3508504;Caçapava;2019;178;2,0;63;0,7;115;1,3
3509007;Caieiras;2019;110;1,1;65;0,7;45;0,5
3509205;Cajamar;2019;149;2,0;49;0,6;100;1,3
3509403;Cajuru;2019;140;5,5;55;2,2;85;3,3
3509502;Campinas;2019;2.578;2,2;1.316;1,1;1.262;1,1
3510302;Capela do Alto;2019;59;2,9;14;0,7;45;2,2
3510401;Capivari;2019;93;1,7;47;0,9;46;0,9
3510500;Caraguatatuba;2019;165;1,4;111;1,0;54;0,5
3510609;Carapicuíba;2019;270;0,7;220;0,6;50;0,1
3510807;Casa Branca;2019;372;12,7;356;12,1;16;0,5
3511102;Catanduva;2019;588;5,0;374;3,2;214;1,8
3511300;Cedral;2019;50;5,7;0;0,0;50;5,7
3512803;Cosmópolis;2019;68;1,0;33;0,5;35;0,5
3513009;Cotia;2019;667;2,7;111;0,5;556;2,3
3513405;Cruzeiro;2019;103;1,3;67;0,8;36;0,5
3513504;Cubatão;2019;118;0,9;66;0,5;52;0,4
3513801;Diadema;2019;624;1,5;555;1,4;69;0,2
3514403;Dracena;2019;143;3,2;108;2,4;35;0,8
3515004;Embu das Artes;2019;244;0,9;89;0,3;155;0,6
3515186;Espírito Santo do Pinhal;2019;452;10,6;354;8,3;98;2,3
3515509;Fernandópolis;2019;135;2,0;84;1,3;51;0,8
3516200;Franca;2019;739;2,2;488;1,4;251;0,7
3516408;Franco da Rocha;2019;693;4,6;611;4,1;82;0,5
3516705;Garça;2019;281;6,6;252;5,9;29;0,7
3518206;Guararapes;2019;74;2,3;48;1,5;26;0,8
3518404;Guaratinguetá;2019;265;2,3;156;1,3;109;0,9
3518701;Guarujá;2019;336;1,1;225;0,7;111;0,4
3518800;Guarulhos;2019;1.987;1,5;1.444;1,1;543;0,4
3519071;Hortolândia;2019;100;0,4;78;0,3;22;0,1
3519600;Ibitinga;2019;103;1,8;46;0,8;57;1,0
3519709;Ibiúna;2019;172;2,3;63;0,8;109;1,4
3520442;Ilha Solteira;2019;116;4,5;74;2,9;42;1,6
3520509;Indaiatuba;2019;350;1,5;207;0,9;143;0,6
3520707;Indiaporã;2019;36;9,3;4;1,0;32;8,3
3522208;Itapecerica da Serra;2019;583;3,5;176;1,0;407;2,4
3522307;Itapetininga;2019;142;0,9;100;0,6;42;0,3
3522406;Itapeva;2019;134;1,5;93;1,0;41;0,4
3522505;Itapevi;2019;307;1,3;213;0,9;94;0,4
3522604;Itapira;2019;988;13,9;576;8,1;412;5,8
3522703;Itápolis;2019;76;1,8;46;1,1;30;0,7
3523206;Itararé;2019;80;1,6;64;1,3;16;0,3
3523404;Itatiba;2019;119;1,0;69;0,6;50;0,4
3523909;Itu;2019;389;2,3;357;2,1;32;0,2
3524006;Itupeva;2019;86;1,5;48;0,8;38;0,7
3524105;Ituverava;2019;120;3,0;53;1,3;67;1,7
3524303;Jaboticabal;2019;212;2,9;56;0,8;156;2,1
3524402;Jacareí;2019;404;1,8;167;0,7;237;1,0
3524501;Jaci;2019;216;31,6;149;21,8;67;9,8
3524808;Jales;2019;151;3,2;103;2,2;48;1,0
3525300;Jaú;2019;895;6,1;711;4,9;184;1,3
3525706;José Bonifácio;2019;53;1,5;22;0,6;31;0,9
3525904;Jundiaí;2019;824;2,0;439;1,1;385;1,0
3526001;Junqueirópolis;2019;52;2,6;25;1,3;27;1,4
3526209;Juquitiba;2019;59;2,0;0;0,0;59;2,0
3526704;Leme;2019;122;1,2;77;0,8;45;0,4
3526803;Lençóis Paulista;2019;88;1,3;45;0,7;43;0,7
3526902;Limeira;2019;377;1,3;174;0,6;203;0,7
3527108;Lins;2019;428;5,7;324;4,3;104;1,4
3527207;Lorena;2019;164;1,9;85;1,0;79;0,9
3529005;Marília;2019;822;3,6;618;2,7;204;0,9
3529302;Matão;2019;162;2,0;96;1,2;66;0,8
3529401;Mauá;2019;402;0,9;189;0,4;213;0,5
3530508;Mococa;2019;135;2,0;88;1,3;47;0,7
3530607;Mogi das Cruzes;2019;896;2,1;600;1,4;296;0,7
3530706;Mogi Guaçu;2019;333;2,3;141;1,0;192;1,3
3530805;Mogi Mirim;2019;213;2,4;114;1,3;99;1,1
3531308;Monte Alto;2019;109;2,3;58;1,2;51;1,1
3531902;Morro Agudo;2019;45;1,4;31;1,0;14;0,4
3532603;Nhandeara;2019;129;12,0;35;3,2;94;8,7
3533007;Nova Granada;2019;62;3,0;19;0,9;43;2,1
3533502;Novo Horizonte;2019;105;2,7;35;0,9;70;1,8
3533908;Olímpia;2019;79;1,5;42;0,8;37;0,7
3534302;Orlândia;2019;98;2,3;60;1,4;38;0,9
3534401;Osasco;2019;878;1,3;578;0,9;300;0,4
3534609;Osvaldo Cruz;2019;77;2,5;53;1,7;24;0,8
3534708;Ourinhos;2019;166;1,5;83;0,8;83;0,8
3535408;Panorama;2019;36;2,4;35;2,3;1;0,1
3537305;Penápolis;2019;200;3,3;173;2,9;27;0,4
3538006;Pindamonhangaba;2019;254;1,6;127;0,8;127;0,8
3538709;Piracicaba;2019;711;1,8;331;0,9;380;1,0
3538907;Pirajuí;2019;288;12,4;67;2,9;221;9,5
3539004;Pirangi;2019;41;3,8;9;0,8;32;3,0
3539301;Pirassununga;2019;151;2,1;57;0,8;94;1,3
3540200;Pontal;2019;45;0,9;29;0,6;16;0,3
3540705;Porto Ferreira;2019;55;1,0;33;0,6;22;0,4
3541406;Presidente Prudente;2019;1.165;5,3;689;3,1;476;2,2
3541505;Presidente Venceslau;2019;96;2,5;60;1,6;36;0,9
3542206;Rancharia;2019;103;3,6;71;2,5;32;1,1
3542602;Registro;2019;181;3,3;128;2,4;53;1,0
3543006;Ribeirão Branco;2019;36;2,0;35;2,0;1;0,1
3543303;Ribeirão Pires;2019;164;1,4;50;0,4;114;1,0
3543402;Ribeirão Preto;2019;2.183;3,2;1.388;2,1;795;1,2
3543907;Rio Claro;2019;391;2,0;188;0,9;203;1,0
3544202;Riolândia;2019;36;3,2;7;0,6;29;2,6
3544301;Roseira;2019;54;5,1;14;1,3;40;3,8
3545209;Salto;2019;130;1,1;82;0,7;48;0,4
3545605;Santa Adélia;2019;24;1,6;7;0,5;17;1,1
3545803;Santa Bárbara d'Oeste;2019;160;0,9;97;0,5;63;0,3
3546405;Santa Cruz do Rio Pardo;2019;96;2,1;55;1,2;41;0,9
3546603;Santa Fé do Sul;2019;82;2,7;57;1,9;25;0,8
3547502;Santa Rita do Passa Quatro;2019;316;12,0;293;11,1;23;0,9
3547809;Santo André;2019;1.540;2,2;708;1,0;832;1,2
3548500;Santos;2019;1.716;4,0;858;2,0;858;2,0
3548609;São Bento do Sapucaí;2019;40;3,8;26;2,5;14;1,3
3548708;São Bernardo do Campo;2019;1.583;2,0;588;0,7;995;1,2
3548807;São Caetano do Sul;2019;618;4,1;177;1,2;441;2,9
3548906;São Carlos;2019;436;1,8;211;0,9;225;0,9
3549102;São João da Boa Vista;2019;199;2,3;94;1,1;105;1,2
3549409;São Joaquim da Barra;2019;115;2,3;68;1,4;47;0,9
3549706;São José do Rio Pardo;2019;136;2,6;81;1,5;55;1,0
3549805;São José do Rio Preto;2019;1.905;4,3;886;2,0;1.019;2,3
3549904;São José dos Campos;2019;1.672;2,4;824;1,2;848;1,2
3550308;São Paulo;2019;28.494;2,4;14.530;1,2;13.964;1,2
3550407;São Pedro;2019;62;1,8;40;1,2;22;0,6
3550605;São Roque;2019;97;1,1;46;0,5;51;0,6
3551009;São Vicente;2019;269;0,8;158;0,4;111;0,3
3551603;Serra Negra;2019;49;1,8;33;1,2;16;0,6
3551702;Sertãozinho;2019;162;1,3;66;0,5;96;0,8
3552205;Sorocaba;2019;1.429;2,2;853;1,3;576;0,9
3552502;Suzano;2019;139;0,5;61;0,2;78;0,3
3552809;Taboão da Serra;2019;482;1,7;321;1,1;161;0,6
3553708;Taquaritinga;2019;124;2,3;72;1,3;52;1,0
3554003;Tatuí;2019;129;1,1;78;0,7;51;0,4
3554102;Taubaté;2019;509;1,7;330;1,1;179;0,6
3554508;Tietê;2019;55;1,4;33;0,8;22;0,5
3555000;Tupã;2019;446;7,1;330;5,2;116;1,8
3556008;Urupês;2019;34;2,6;11;0,8;23;1,8
3556206;Valinhos;2019;142;1,2;57;0,5;85;0,7
3556305;Valparaíso;2019;55;2,3;31;1,3;24;1,0
3556453;Vargem Grande Paulista;2019;70;1,4;2;0,0;68;1,3
3556602;Vera Cruz;2019;72;6,8;0;0,0;72;6,8
3556701;Vinhedo;2019;85;1,1;62;0,8;23;0,3
3557006;Votorantim;2019;212;1,8;53;0,4;159;1,3
3557105;Votuporanga;2019;205;2,3;115;1,3;90;1,0
3500501;Águas de Lindóia;2019;42;2,3;30;1,6;12;0,7
3511003;Castilho;2019;31;1,5;30;1,5;1;0,0
3516002;Flórida Paulista;2019;47;3,9;30;2,5;17;1,4
3529203;Martinópolis;2019;35;1,4;30;1,2;5;0,2
3530300;Mirassol;2019;81;1,4;30;0,5;51;0,9
3531407;Monte Aprazível;2019;80;3,4;30;1,3;50;2,1
3553401;Tanabi;2019;72;2,9;30;1,2;42;1,7
3554409;Terra Roxa;2019;34;3,8;30;3,3;4;0,4
3555109;Tupi Paulista;2019;48;3,2;30;2,0;18;1,2
3556800;Viradouro;2019;48;2,6;30;1,6;18;1,0
3557204;Chavantes;2019;50;4,1;30;2,5;20;1,6
3500204;Adolfo;2018;0;0,0;0;0,0;0;0,0
3500402;Águas da Prata;2018;0;0,0;0;0,0;0;0,0
3500550;Águas de Santa Bárbara;2018;0;0,0;0;0,0;0;0,0
3500600;Águas de São Pedro;2018;0;0,0;0;0,0;0;0,0
3500758;Alambari;2018;0;0,0;0;0,0;0;0,0
3500808;Alfredo Marcondes;2018;0;0,0;0;0,0;0;0,0
3500907;Altair;2018;0;0,0;0;0,0;0;0,0
3501152;Alumínio;2018;0;0,0;0;0,0;0;0,0
3501202;Álvares Florence;2018;0;0,0;0;0,0;0;0,0
3501400;Álvaro de Carvalho;2018;0;0,0;0;0,0;0;0,0
3501509;Alvinlândia;2018;0;0,0;0;0,0;0;0,0
3501806;Américo de Campos;2018;0;0,0;0;0,0;0;0,0
3502002;Analândia;2018;0;0,0;0;0,0;0;0,0
3502309;Anhembi;2018;0;0,0;0;0,0;0;0,0
3502408;Anhumas;2018;0;0,0;0;0,0;0;0,0
3502754;Araçariguama;2018;0;0,0;0;0,0;0;0,0
3503000;Aramina;2018;0;0,0;0;0,0;0;0,0
3503158;Arapeí;2018;0;0,0;0;0,0;0;0,0
3503356;Arco-Íris;2018;0;0,0;0;0,0;0;0,0
3503505;Areias;2018;0;0,0;0;0,0;0;0,0
3503604;Areiópolis;2018;0;0,0;0;0,0;0;0,0
3503950;Aspásia;2018;0;0,0;0;0,0;0;0,0
3504305;Avaí;2018;0;0,0;0;0,0;0;0,0
3504404;Avanhandava;2018;0;0,0;0;0,0;0;0,0
3504602;Bady Bassitt;2018;0;0,0;0;0,0;0;0,0
3504701;Balbinos;2018;0;0,0;0;0,0;0;0,0
3504800;Bálsamo;2018;0;0,0;0;0,0;0;0,0
3505005;Barão de Antonina;2018;0;0,0;0;0,0;0;0,0
3505104;Barbosa;2018;0;0,0;0;0,0;0;0,0
3505351;Barra do Chapéu;2018;0;0,0;0;0,0;0;0,0
3505401;Barra do Turvo;2018;0;0,0;0;0,0;0;0,0
3505609;Barrinha;2018;0;0,0;0;0,0;0;0,0
3506201;Bento de Abreu;2018;0;0,0;0;0,0;0;0,0
3506607;Biritiba Mirim;2018;0;0,0;0;0,0;0;0,0
3506904;Bofete;2018;0;0,0;0;0,0;0;0,0
3507159;Bom Sucesso de Itararé;2018;0;0,0;0;0,0;0;0,0
3507209;Borá;2018;0;0,0;0;0,0;0;0,0
3507308;Boracéia;2018;0;0,0;0;0,0;0;0,0
3507456;Borebi;2018;0;0,0;0;0,0;0;0,0
3507704;Braúna;2018;0;0,0;0;0,0;0;0,0
3507753;Brejo Alegre;2018;0;0,0;0;0,0;0;0,0
3507803;Brodowski;2018;0;0,0;0;0,0;0;0,0
3508009;Buri;2018;0;0,0;0;0,0;0;0,0
3508207;Buritizal;2018;0;0,0;0;0,0;0;0,0
3508306;Cabrália Paulista;2018;0;0,0;0;0,0;0;0,0
3508900;Caiabu;2018;0;0,0;0;0,0;0;0,0
3509106;Caiuá;2018;0;0,0;0;0,0;0;0,0
3509254;Cajati;2018;0;0,0;0;0,0;0;0,0
3509452;Campina do Monte Alegre;2018;0;0,0;0;0,0;0;0,0
3509809;Campos Novos Paulista;2018;0;0,0;0;0,0;0;0,0
3509908;Cananéia;2018;0;0,0;0;0,0;0;0,0
3509957;Canas;2018;0;0,0;0;0,0;0;0,0
3510104;Cândido Rodrigues;2018;0;0,0;0;0,0;0;0,0
3510153;Canitar;2018;0;0,0;0;0,0;0;0,0
3510906;Cássia dos Coqueiros;2018;0;0,0;0;0,0;0;0,0
3511201;Catiguá;2018;0;0,0;0;0,0;0;0,0
3512407;Cordeirópolis;2018;0;0,0;0;0,0;0;0,0
3512506;Coroados;2018;0;0,0;0;0,0;0;0,0
3512704;Corumbataí;2018;0;0,0;0;0,0;0;0,0
3512902;Cosmorama;2018;0;0,0;0;0,0;0;0,0
3513207;Cristais Paulista;2018;0;0,0;0;0,0;0;0,0
3513306;Cruzália;2018;0;0,0;0;0,0;0;0,0
3513850;Dirce Reis;2018;0;0,0;0;0,0;0;0,0
3514007;Dobrada;2018;0;0,0;0;0,0;0;0,0
3514205;Dolcinópolis;2018;0;0,0;0;0,0;0;0,0
3514601;Dumont;2018;0;0,0;0;0,0;0;0,0
3514700;Echaporã;2018;0;0,0;0;0,0;0;0,0
3514924;Elisiário;2018;0;0,0;0;0,0;0;0,0
3514957;Embaúba;2018;0;0,0;0;0,0;0;0,0
3515129;Emilianópolis;2018;0;0,0;0;0,0;0;0,0
3515152;Engenheiro Coelho;2018;0;0,0;0;0,0;0;0,0
3515194;Espírito Santo do Turvo;2018;0;0,0;0;0,0;0;0,0
3515301;Estrela do Norte;2018;0;0,0;0;0,0;0;0,0
3515350;Euclides da Cunha Paulista;2018;0;0,0;0;0,0;0;0,0
3515608;Fernando Prestes;2018;0;0,0;0;0,0;0;0,0
3515657;Fernão;2018;0;0,0;0;0,0;0;0,0
3515806;Flora Rica;2018;0;0,0;0;0,0;0;0,0
3515905;Floreal;2018;0;0,0;0;0,0;0;0,0
3516101;Florínea;2018;0;0,0;0;0,0;0;0,0
3516507;Gabriel Monteiro;2018;0;0,0;0;0,0;0;0,0
3516804;Gastão Vidigal;2018;0;0,0;0;0,0;0;0,0
3516853;Gavião Peixoto;2018;0;0,0;0;0,0;0;0,0
3517109;Glicério;2018;0;0,0;0;0,0;0;0,0
3517208;Guaiçara;2018;0;0,0;0;0,0;0;0,0
3517307;Guaimbê;2018;0;0,0;0;0,0;0;0,0
3517505;Guapiaçu;2018;0;0,0;0;0,0;0;0,0
3517901;Guaraci;2018;0;0,0;0;0,0;0;0,0
3518008;Guarani d'Oeste;2018;0;0,0;0;0,0;0;0,0
3518107;Guarantã;2018;0;0,0;0;0,0;0;0,0
3518503;Guareí;2018;0;0,0;0;0,0;0;0,0
3518859;Guatapará;2018;0;0,0;0;0,0;0;0,0
3518909;Guzolândia;2018;0;0,0;0;0,0;0;0,0
3519055;Holambra;2018;0;0,0;0;0,0;0;0,0
3519204;Iacri;2018;0;0,0;0;0,0;0;0,0
3519253;Iaras;2018;0;0,0;0;0,0;0;0,0
3519501;Ibirarema;2018;0;0,0;0;0,0;0;0,0
3519808;Icém;2018;0;0,0;0;0,0;0;0,0
3520426;Ilha Comprida;2018;0;0,0;0;0,0;0;0,0
3520608;Indiana;2018;0;0,0;0;0,0;0;0,0
3520806;Inúbia Paulista;2018;0;0,0;0;0,0;0;0,0
3521101;Ipeúna;2018;0;0,0;0;0,0;0;0,0
3521150;Ipiguá;2018;0;0,0;0;0,0;0;0,0
3521200;Iporanga;2018;0;0,0;0;0,0;0;0,0
3521507;Irapuã;2018;0;0,0;0;0,0;0;0,0
3521606;Irapuru;2018;0;0,0;0;0,0;0;0,0
3522000;Itaju;2018;0;0,0;0;0,0;0;0,0
3522158;Itaoca;2018;0;0,0;0;0,0;0;0,0
3522653;Itapirapuã Paulista;2018;0;0,0;0;0,0;0;0,0
3523008;Itapura;2018;0;0,0;0;0,0;0;0,0
3523305;Itariri;2018;0;0,0;0;0,0;0;0,0
3523701;Itirapuã;2018;0;0,0;0;0,0;0;0,0
3523800;Itobi;2018;0;0,0;0;0,0;0;0,0
3524600;Jacupiranga;2018;0;0,0;0;0,0;0;0,0
3524907;Jambeiro;2018;0;0,0;0;0,0;0;0,0
3525102;Jardinópolis;2018;0;0,0;0;0,0;0;0,0
3525409;Jeriquara;2018;0;0,0;0;0,0;0;0,0
3525607;João Ramalho;2018;0;0,0;0;0,0;0;0,0
3525805;Júlio Mesquita;2018;0;0,0;0;0,0;0;0,0
3525854;Jumirim;2018;0;0,0;0;0,0;0;0,0
3526100;Juquiá;2018;0;0,0;0;0,0;0;0,0
3526308;Lagoinha;2018;0;0,0;0;0,0;0;0,0
3526506;Lavínia;2018;0;0,0;0;0,0;0;0,0
3526605;Lavrinhas;2018;0;0,0;0;0,0;0;0,0
3527009;Lindóia;2018;0;0,0;0;0,0;0;0,0
3527256;Lourdes;2018;0;0,0;0;0,0;0;0,0
3527504;Lucianópolis;2018;0;0,0;0;0,0;0;0,0
3527603;Luís Antônio;2018;0;0,0;0;0,0;0;0,0
3527801;Lupércio;2018;0;0,0;0;0,0;0;0,0
3527900;Lutécia;2018;0;0,0;0;0,0;0;0,0
3528205;Macedônia;2018;0;0,0;0;0,0;0;0,0
3528304;Magda;2018;0;0,0;0;0,0;0;0,0
3528403;Mairinque;2018;0;0,0;0;0,0;0;0,0
3528601;Manduri;2018;0;0,0;0;0,0;0;0,0
3528700;Marabá Paulista;2018;0;0,0;0;0,0;0;0,0
3528858;Marapoama;2018;0;0,0;0;0,0;0;0,0
3528908;Mariápolis;2018;0;0,0;0;0,0;0;0,0
3529104;Marinópolis;2018;0;0,0;0;0,0;0;0,0
3529500;Mendonça;2018;0;0,0;0;0,0;0;0,0
3529609;Meridiano;2018;0;0,0;0;0,0;0;0,0
3529658;Mesópolis;2018;0;0,0;0;0,0;0;0,0
3529906;Miracatu;2018;0;0,0;0;0,0;0;0,0
3530003;Mira Estrela;2018;0;0,0;0;0,0;0;0,0
3530201;Mirante do Paranapanema;2018;0;0,0;0;0,0;0;0,0
3530409;Mirassolândia;2018;0;0,0;0;0,0;0;0,0
3530904;Mombuca;2018;0;0,0;0;0,0;0;0,0
3531001;Monções;2018;0;0,0;0;0,0;0;0,0
3531209;Monte Alegre do Sul;2018;0;0,0;0;0,0;0;0,0
3531605;Monte Castelo;2018;0;0,0;0;0,0;0;0,0
3531704;Monteiro Lobato;2018;0;0,0;0;0,0;0;0,0
3532058;Motuca;2018;0;0,0;0;0,0;0;0,0
3532108;Murutinga do Sul;2018;0;0,0;0;0,0;0;0,0
3532157;Nantes;2018;0;0,0;0;0,0;0;0,0
3532207;Narandiba;2018;0;0,0;0;0,0;0;0,0
3532306;Natividade da Serra;2018;0;0,0;0;0,0;0;0,0
3532702;Nipoã;2018;0;0,0;0;0,0;0;0,0
3532801;Nova Aliança;2018;0;0,0;0;0,0;0;0,0
3532827;Nova Campina;2018;0;0,0;0;0,0;0;0,0
3532843;Nova Canaã Paulista;2018;0;0,0;0;0,0;0;0,0
3532868;Nova Castilho;2018;0;0,0;0;0,0;0;0,0
3533106;Nova Guataporanga;2018;0;0,0;0;0,0;0;0,0
3533205;Nova Independência;2018;0;0,0;0;0,0;0;0,0
3533254;Novais;2018;0;0,0;0;0,0;0;0,0
3533304;Nova Luzitânia;2018;0;0,0;0;0,0;0;0,0
3533601;Nuporanga;2018;0;0,0;0;0,0;0;0,0
3533700;Ocauçu;2018;0;0,0;0;0,0;0;0,0
3533809;Óleo;2018;0;0,0;0;0,0;0;0,0
3534005;Onda Verde;2018;0;0,0;0;0,0;0;0,0
3534104;Oriente;2018;0;0,0;0;0,0;0;0,0
3534203;Orindiúva;2018;0;0,0;0;0,0;0;0,0
3534500;Oscar Bressane;2018;0;0,0;0;0,0;0;0,0
3534807;Ouro Verde;2018;0;0,0;0;0,0;0;0,0
3535002;Palestina;2018;0;0,0;0;0,0;0;0,0
3535101;Palmares Paulista;2018;0;0,0;0;0,0;0;0,0
3535606;Paraibuna;2018;0;0,0;0;0,0;0;0,0
3535705;Paraíso;2018;0;0,0;0;0,0;0;0,0
3535903;Paranapuã;2018;0;0,0;0;0,0;0;0,0
3536109;Pardinho;2018;0;0,0;0;0,0;0;0,0
3536257;Parisi;2018;0;0,0;0;0,0;0;0,0
3536406;Paulicéia;2018;0;0,0;0;0,0;0;0,0
3536570;Paulistânia;2018;0;0,0;0;0,0;0;0,0
3536802;Pedra Bela;2018;0;0,0;0;0,0;0;0,0
3536901;Pedranópolis;2018;0;0,0;0;0,0;0;0,0
3537156;Pedrinhas Paulista;2018;0;0,0;0;0,0;0;0,0
3537206;Pedro de Toledo;2018;0;0,0;0;0,0;0;0,0
3537503;Pereiras;2018;0;0,0;0;0,0;0;0,0
3537701;Piacatu;2018;0;0,0;0;0,0;0;0,0
3538105;Pindorama;2018;0;0,0;0;0,0;0;0,0
3538204;Pinhalzinho;2018;0;0,0;0;0,0;0;0,0
3538303;Piquerobi;2018;0;0,0;0;0,0;0;0,0
3538501;Piquete;2018;0;0,0;0;0,0;0;0,0
3539103;Pirapora do Bom Jesus;2018;0;0,0;0;0,0;0;0,0
3539202;Pirapozinho;2018;0;0,0;0;0,0;0;0,0
3539608;Planalto;2018;0;0,0;0;0,0;0;0,0
3539707;Platina;2018;0;0,0;0;0,0;0;0,0
3539905;Poloni;2018;0;0,0;0;0,0;0;0,0
3540101;Pongaí;2018;0;0,0;0;0,0;0;0,0
3540259;Pontalinda;2018;0;0,0;0;0,0;0;0,0
3540309;Pontes Gestal;2018;0;0,0;0;0,0;0;0,0
3540507;Porangaba;2018;0;0,0;0;0,0;0;0,0
3540754;Potim;2018;0;0,0;0;0,0;0;0,0
3540853;Pracinha;2018;0;0,0;0;0,0;0;0,0
3540903;Pradópolis;2018;0;0,0;0;0,0;0;0,0
3541059;Pratânia;2018;0;0,0;0;0,0;0;0,0
3541653;Quadra;2018;0;0,0;0;0,0;0;0,0
3541703;Quatá;2018;0;0,0;0;0,0;0;0,0
3541802;Queiroz;2018;0;0,0;0;0,0;0;0,0
3542008;Quintana;2018;0;0,0;0;0,0;0;0,0
3542107;Rafard;2018;0;0,0;0;0,0;0;0,0
3542305;Redenção da Serra;2018;0;0,0;0;0,0;0;0,0
3542503;Reginópolis;2018;0;0,0;0;0,0;0;0,0
3542701;Restinga;2018;0;0,0;0;0,0;0;0,0
3542800;Ribeira;2018;0;0,0;0;0,0;0;0,0
3543105;Ribeirão Corrente;2018;0;0,0;0;0,0;0;0,0
3543204;Ribeirão do Sul;2018;0;0,0;0;0,0;0;0,0
3543238;Ribeirão dos Índios;2018;0;0,0;0;0,0;0;0,0
3543253;Ribeirão Grande;2018;0;0,0;0;0,0;0;0,0
3543501;Riversul;2018;0;0,0;0;0,0;0;0,0
3543600;Rifaina;2018;0;0,0;0;0,0;0;0,0
3543709;Rincão;2018;0;0,0;0;0,0;0;0,0
3544103;Rio Grande da Serra;2018;0;0,0;0;0,0;0;0,0
3544400;Rubiácea;2018;0;0,0;0;0,0;0;0,0
3544509;Rubinéia;2018;0;0,0;0;0,0;0;0,0
3544608;Sabino;2018;0;0,0;0;0,0;0;0,0
3544707;Sagres;2018;0;0,0;0;0,0;0;0,0
3544806;Sales;2018;0;0,0;0;0,0;0;0,0
3545100;Salmourão;2018;0;0,0;0;0,0;0;0,0
3545159;Saltinho;2018;0;0,0;0;0,0;0;0,0
3545506;Sandovalina;2018;0;0,0;0;0,0;0;0,0
3545704;Santa Albertina;2018;0;0,0;0;0,0;0;0,0
3546009;Santa Branca;2018;0;0,0;0;0,0;0;0,0
3546108;Santa Clara d'Oeste;2018;0;0,0;0;0,0;0;0,0
3546207;Santa Cruz da Conceição;2018;0;0,0;0;0,0;0;0,0
3546256;Santa Cruz da Esperança;2018;0;0,0;0;0,0;0;0,0
3546504;Santa Ernestina;2018;0;0,0;0;0,0;0;0,0
3546702;Santa Gertrudes;2018;0;0,0;0;0,0;0;0,0
3546900;Santa Lúcia;2018;0;0,0;0;0,0;0;0,0
3547106;Santa Mercedes;2018;0;0,0;0;0,0;0;0,0
3547205;Santana da Ponte Pensa;2018;0;0,0;0;0,0;0;0,0
3547403;Santa Rita d'Oeste;2018;0;0,0;0;0,0;0;0,0
3547650;Santa Salete;2018;0;0,0;0;0,0;0;0,0
3548005;Santo Antônio de Posse;2018;0;0,0;0;0,0;0;0,0
3548054;Santo Antônio do Aracanguá;2018;0;0,0;0;0,0;0;0,0
3548104;Santo Antônio do Jardim;2018;0;0,0;0;0,0;0;0,0
3548203;Santo Antônio do Pinhal;2018;0;0,0;0;0,0;0;0,0
3548302;Santo Expedito;2018;0;0,0;0;0,0;0;0,0
3548401;Santópolis do Aguapeí;2018;0;0,0;0;0,0;0;0,0
3549003;São Francisco;2018;0;0,0;0;0,0;0;0,0
3549201;São João das Duas Pontes;2018;0;0,0;0;0,0;0;0,0
3549250;São João de Iracema;2018;0;0,0;0;0,0;0;0,0
3549300;São João do Pau d'Alho;2018;0;0,0;0;0,0;0;0,0
3549508;São José da Bela Vista;2018;0;0,0;0;0,0;0;0,0
3549607;São José do Barreiro;2018;0;0,0;0;0,0;0;0,0
3549953;São Lourenço da Serra;2018;0;0,0;0;0,0;0;0,0
3550506;São Pedro do Turvo;2018;0;0,0;0;0,0;0;0,0
3551108;Sarapuí;2018;0;0,0;0;0,0;0;0,0
3551207;Sarutaiá;2018;0;0,0;0;0,0;0;0,0
3551306;Sebastianópolis do Sul;2018;0;0,0;0;0,0;0;0,0
3551405;Serra Azul;2018;0;0,0;0;0,0;0;0,0
3551801;Sete Barras;2018;0;0,0;0;0,0;0;0,0
3551900;Severínia;2018;0;0,0;0;0,0;0;0,0
3552551;Suzanápolis;2018;0;0,0;0;0,0;0;0,0
3552908;Taciba;2018;0;0,0;0;0,0;0;0,0
3553104;Taiaçu;2018;0;0,0;0;0,0;0;0,0
3553500;Tapiraí;2018;0;0,0;0;0,0;0;0,0
3553658;Taquaral;2018;0;0,0;0;0,0;0;0,0
3553856;Taquarivaí;2018;0;0,0;0;0,0;0;0,0
3553906;Tarabai;2018;0;0,0;0;0,0;0;0,0
3553955;Tarumã;2018;0;0,0;0;0,0;0;0,0
3554201;Tejupá;2018;0;0,0;0;0,0;0;0,0
3554607;Timburi;2018;0;0,0;0;0,0;0;0,0
3554656;Torre de Pedra;2018;0;0,0;0;0,0;0;0,0
3554755;Trabiju;2018;0;0,0;0;0,0;0;0,0
3554805;Tremembé;2018;0;0,0;0;0,0;0;0,0
3554904;Três Fronteiras;2018;0;0,0;0;0,0;0;0,0
3554953;Tuiuti;2018;0;0,0;0;0,0;0;0,0
3555208;Turiúba;2018;0;0,0;0;0,0;0;0,0
3555307;Turmalina;2018;0;0,0;0;0,0;0;0,0
3555356;Ubarana;2018;0;0,0;0;0,0;0;0,0
3555505;Ubirajara;2018;0;0,0;0;0,0;0;0,0
3555604;Uchoa;2018;0;0,0;0;0,0;0;0,0
3555703;União Paulista;2018;0;0,0;0;0,0;0;0,0
3555901;Uru;2018;0;0,0;0;0,0;0;0,0
3556107;Valentim Gentil;2018;0;0,0;0;0,0;0;0,0
3556354;Vargem;2018;0;0,0;0;0,0;0;0,0
3556909;Vista Alegre do Alto;2018;0;0,0;0;0,0;0;0,0
3556958;Vitória Brasil;2018;0;0,0;0;0,0;0;0,0
3557154;Zacarias;2018;0;0,0;0;0,0;0;0,0
3557303;Estiva Gerbi;2018;0;0,0;0;0,0;0;0,0
3501707;Américo Brasiliense;2018;198;5,1;198;5,1;0;0,0
3503109;Arandu;2018;16;2,6;16;2,6;0;0,0
3504909;Bananal;2018;15;1,4;15;1,4;0;0,0
3506300;Bernardino de Campos;2018;23;2,1;23;2,1;0;0,0
3506359;Bertioga;2018;49;0,8;49;0,8;0;0,0
3506409;Bilac;2018;36;4,7;36;4,7;0;0,0
3507100;Bom Jesus dos Perdões;2018;12;0,5;12;0,5;0;0,0
3508702;Caconde;2018;62;3,3;62;3,3;0;0,0
3509601;Campo Limpo Paulista;2018;68;0,8;68;0,8;0;0,0
3510302;Capela do Alto;2018;14;0,7;14;0,7;0;0,0
3512100;Colômbia;2018;20;3,3;20;3,3;0;0,0
3512308;Conchas;2018;32;1,9;32;1,9;0;0,0
3512605;Coronel Macedo;2018;6;1,2;6;1,2;0;0,0
3513900;Divinolândia;2018;186;17,0;186;17,0;0;0,0
3514304;Dourado;2018;14;1,6;14;1,6;0;0,0
3514809;Eldorado;2018;2;0,1;2;0,1;0;0,0
3514908;Elias Fausto;2018;6;0,4;6;0,4;0;0,0
3515103;Embu-Guaçu;2018;16;0,2;16;0,2;0;0,0
3515707;Ferraz de Vasconcelos;2018;189;1,0;189;1,0;0;0,0
3517604;Guapiara;2018;19;1,1;19;1,1;0;0,0
3519006;Herculândia;2018;58;6,3;58;6,3;0;0,0
3519303;Ibaté;2018;32;0,9;32;0,9;0;0,0
3519907;Iepê;2018;20;2,5;20;2,5;0;0,0
3520202;Igaratá;2018;15;1,6;15;1,6;0;0,0
3520301;Iguape;2018;9;0,3;9;0,3;0;0,0
3520400;Ilhabela;2018;46;1,4;46;1,4;0;0,0
3521002;Iperó;2018;15;0,5;15;0,5;0;0,0
3521408;Iracemápolis;2018;2;0,1;2;0,1;0;0,0
3521705;Itaberá;2018;35;2,0;35;2,0;0;0,0
3521804;Itaí;2018;35;1,3;35;1,3;0;0,0
3522109;Itanhaém;2018;131;1,4;131;1,4;0;0,0
3523107;Itaquaquecetuba;2018;224;0,6;224;0,6;0;0,0
3523602;Itirapina;2018;25;1,5;25;1,5;0;0,0
3524204;Jaborandi;2018;17;2,6;17;2,6;0;0,0
3525508;Joanópolis;2018;11;0,9;11;0,9;0;0,0
3527702;Luiziânia;2018;3;0,5;3;0,5;0;0,0
3529807;Mineiros do Tietê;2018;5;0,4;5;0,4;0;0,0
3530102;Mirandópolis;2018;68;2,4;68;2,4;0;0,0
3531100;Mongaguá;2018;48;0,9;48;0,9;0;0,0
3532405;Nazaré Paulista;2018;20;1,1;20;1,1;0;0,0
3533403;Nova Odessa;2018;53;0,9;53;0,9;0;0,0
3535804;Paranapanema;2018;30;1,5;30;1,5;0;0,0
3536208;Pariquera-Açu;2018;150;7,9;150;7,9;0;0,0
3536505;Paulínia;2018;85;0,8;85;0,8;0;0,0
3537107;Pedreira;2018;98;2,1;98;2,1;0;0,0
3537602;Peruíbe;2018;14;0,2;14;0,2;0;0,0
3539806;Poá;2018;35;0,3;35;0,3;0;0,0
3541604;Promissão;2018;45;1,2;45;1,2;0;0,0
3541901;Queluz;2018;38;3,1;38;3,1;0;0,0
3544251;Rosana;2018;57;3,1;57;3,1;0;0,0
3547007;Santa Maria da Serra;2018;6;1,0;6;1,0;0;0,0
3547304;Santana de Parnaíba;2018;35;0,3;35;0,3;0;0,0
3547908;Santo Antônio da Alegria;2018;21;3,2;21;3,2;0;0,0
3550209;São Miguel Arcanjo;2018;54;1,7;54;1,7;0;0,0
3552007;Silveiras;2018;2;0,3;2;0,3;0;0,0
3553203;Taiúva;2018;4;0,6;4;0,6;0;0,0
3500303;Aguaí;2018;10;0,3;0;0,0;10;0,3
3502705;Apiaí;2018;51;2,1;41;1,7;10;0,4
3507407;Borborema;2018;26;1,7;16;1,1;10;0,7
3509700;Campos do Jordão;2018;201;4,0;191;3,8;10;0,2
3510203;Capão Bonito;2018;58;1,3;48;1,0;10;0,2
3511508;Cerquilho;2018;28;0,6;18;0,4;10;0,2
3511904;Clementina;2018;30;3,7;20;2,5;10;1,2
3514502;Duartina;2018;87;7,2;77;6,4;10;0,8
3521309;Ipuã;2018;49;3,2;39;2,5;10;0,6
3521903;Itajobi;2018;30;2,1;20;1,4;10;0,7
3532009;Morungaba;2018;19;1,5;9;0,7;10;0,8
3535200;Palmeira d'Oeste;2018;20;2,2;10;1,1;10;1,1
3540408;Populina;2018;18;4,5;8;2,0;10;2,5
3541307;Presidente Epitácio;2018;78;1,8;68;1,6;10;0,2
3544905;Sales Oliveira;2018;29;2,6;19;1,7;10;0,9
3555406;Ubatuba;2018;81;0,9;71;0,8;10;0,1
3505203;Bariri;2018;23;0,7;16;0,5;7;0,2
3505807;Bastos;2018;35;1,7;28;1,4;7;0,3
3508603;Cachoeira Paulista;2018;47;1,5;40;1,3;7;0,2
3511409;Cerqueira César;2018;39;2,1;32;1,7;7;0,4
3511706;Charqueada;2018;33;2,0;26;1,6;7;0,4
3518602;Guariba;2018;67;1,7;60;1,6;7;0,2
3523503;Itatinga;2018;14;0,7;7;0,3;7;0,3
3527306;Louveira;2018;34;0,7;27;0,6;7;0,2
3552106;Socorro;2018;70;1,8;63;1,6;7;0,2
3554706;Torrinha;2018;20;2,1;13;1,3;7;0,7
3501004;Altinópolis;2018;31;2,0;25;1,6;6;0,4
3506805;Bocaina;2018;35;2,9;29;2,4;6;0,5
3507902;Brotas;2018;41;1,8;35;1,5;6;0,3
3509304;Cajobi;2018;32;3,2;26;2,6;6;0,6
3518305;Guararema;2018;35;1,2;29;1,0;6;0,2
3528502;Mairiporã;2018;47;0,5;41;0,4;6;0,1
3536000;Parapuã;2018;32;3,0;26;2,5;6;0,6
3536604;Paulo de Faria;2018;24;2,8;18;2,1;6;0,7
3540002;Pompéia;2018;42;2,0;36;1,7;6;0,3
3542909;Ribeirão Bonito;2018;17;1,3;11;0,9;6;0,5
3554300;Teodoro Sampaio;2018;58;2,6;52;2,3;6;0,3
3515400;Fartura;2018;20;1,3;12;0,8;8;0,5
3517703;Guará;2018;30;1,5;22;1,1;8;0,4
3517802;Guaraçaí;2018;23;2,7;15;1,8;8;0,9
3537909;Pilar do Sul;2018;35;1,3;27;1,0;8;0,3
3538600;Piracaia;2018;37;1,4;29;1,1;8;0,3
3550704;São Sebastião;2018;101;1,2;93;1,1;8;0,1
3556503;Várzea Paulista;2018;39;0,3;31;0,3;8;0,1
3508405;Cabreúva;2018;15;0,3;10;0,2;5;0,1
3510005;Cândido Mota;2018;30;1,0;25;0,8;5;0,2
3515004;Embu das Artes;2018;94;0,4;89;0,3;5;0,0
3515202;Estrela d'Oeste;2018;50;6,2;45;5,5;5;0,6
3522901;Itapuí;2018;30;2,2;25;1,9;5;0,4
3527405;Lucélia;2018;15;0,7;10;0,5;5;0,2
3532900;Nova Europa;2018;12;1,1;7;0,7;5;0,5
3534757;Ouroeste;2018;33;3,5;28;2,9;5;0,5
3534906;Pacaembu;2018;37;2,8;32;2,4;5;0,4
3537404;Pereira Barreto;2018;52;2,1;47;1,9;5;0,2
3552403;Sumaré;2018;177;0,6;172;0,6;5;0,0
3553005;Taguaí;2018;29;2,3;24;1,9;5;0,4
3553609;Tapiratiba;2018;24;1,9;19;1,5;5;0,4
3501301;Álvares Machado;2018;20;0,8;18;0,8;2;0,1
3502606;Aparecida d'Oeste;2018;22;5,2;20;4,8;2;0,5
3506706;Boa Esperança do Sul;2018;13;0,9;11;0,8;2;0,1
3512209;Conchal;2018;52;1,9;50;1,9;2;0,1
3513108;Cravinhos;2018;15;0,4;13;0,4;2;0,1
3519105;Iacanga;2018;30;2,7;28;2,5;2;0,2
3524709;Jaguariúna;2018;80;1,5;78;1,5;2;0,0
3545001;Salesópolis;2018;19;1,1;17;1,0;2;0,1
3552304;Sud Mennucci;2018;22;2,9;20;2,6;2;0,3
3555802;Urânia;2018;26;3,0;24;2,8;2;0,2
3510708;Cardoso;2018;31;2,6;12;1,0;19;1,6
3522802;Itaporanga;2018;46;3,1;27;1,8;19;1,3
3529708;Miguelópolis;2018;66;3,1;47;2,2;19;0,9
3531506;Monte Azul Paulista;2018;70;3,8;51;2,8;19;1,0
3535507;Paraguaçu Paulista;2018;97;2,2;78;1,8;19;0,4
3538808;Piraju;2018;77;2,7;58;2,0;19;0,7
3546801;Santa Isabel;2018;101;1,9;82;1,5;19;0,4
3547700;Santo Anastácio;2018;56;2,8;37;1,8;19;0,9
3552601;Tabapuã;2018;30;2,5;11;0,9;19;1,6
3516606;Gália;2018;45;6,8;27;4,1;18;2,7
3517406;Guaíra;2018;60;1,5;42;1,1;18;0,5
3519402;Ibirá;2018;27;2,3;9;0,8;18;1,5
3520103;Igarapava;2018;60;2,1;42;1,4;18;0,6
3523206;Itararé;2018;96;2,0;78;1,6;18;0,4
3526407;Laranjal Paulista;2018;46;1,7;28;1,0;18;0,7
3535309;Palmital;2018;54;2,5;36;1,7;18;0,8
3539509;Pitangueiras;2018;50;1,3;32;0,8;18;0,5
3553807;Taquarituba;2018;49;2,1;31;1,3;18;0,8
3512001;Colina;2018;47;2,7;35;2,0;12;0,7
3516903;General Salgado;2018;32;3,0;20;1,9;12;1,1
3517000;Getulina;2018;48;4,4;36;3,3;12;1,1
3536307;Patrocínio Paulista;2018;35;2,5;23;1,6;12;0,8
3540606;Porto Feliz;2018;51;1,0;39;0,8;12;0,2
3544004;Rio das Pedras;2018;44;1,3;32;1,0;12;0,4
3545407;Salto Grande;2018;34;3,8;22;2,4;12;1,3
3547601;Santa Rosa de Viterbo;2018;30;1,2;18;0,7;12;0,5
3550902;São Simão;2018;50;3,4;38;2,6;12;0,8
3519709;Ibiúna;2018;67;0,9;63;0,8;4;0,1
3528809;Maracaí;2018;26;1,9;22;1,6;4;0,3
3550100;São Manuel;2018;35;0,9;31;0,8;4;0,1
3550803;São Sebastião da Grama;2018;30;2,5;26;2,2;4;0,3
3501103;Alto Alegre;2018;22;5,4;19;4,7;3;0,7
3502200;Angatuba;2018;57;2,4;54;2,2;3;0,1
3528106;Macaubal;2018;18;2,3;15;1,9;3;0,4
3539400;Piratininga;2018;28;2,2;25;1,9;3;0,2
3540804;Potirendaba;2018;31;1,9;28;1,7;3;0,2
3542404;Regente Feijó;2018;16;0,8;13;0,7;3;0,2
3543808;Rinópolis;2018;23;2,4;20;2,0;3;0,3
3503406;Arealva;2018;29;3,6;18;2,2;11;1,4
3508801;Cafelândia;2018;48;2,8;37;2,2;11;0,6
3532504;Neves Paulista;2018;21;2,4;10;1,2;11;1,3
3541208;Presidente Bernardes;2018;51;3,7;40;2,9;11;0,8
3553302;Tambaú;2018;36;1,6;25;1,1;11;0,5
3511607;Cesário Lange;2018;30;1,8;17;1,0;13;0,8
3528007;Macatuba;2018;31;1,8;18;1,1;13;0,8
3541000;Praia Grande;2018;212;0,7;199;0,6;13;0,0
3551504;Serrana;2018;55;1,3;42;1,0;13;0,3
3552700;Tabatinga;2018;35;2,2;22;1,4;13;0,8
3503703;Ariranha;2018;25;2,7;4;0,4;21;2,3
3546306;Santa Cruz das Palmeiras;2018;46;1,4;25;0,8;21;0,6
3556008;Urupês;2018;34;2,6;13;1,0;21;1,6
3504206;Auriflama;2018;44;3,0;35;2,4;9;0,6
3531803;Monte Mor;2018;35;0,6;26;0,5;9;0,2
3508108;Buritama;2018;42;2,6;22;1,3;20;1,2
3514106;Dois Córregos;2018;67;2,5;47;1,8;20;0,8
3520905;Ipaussu;2018;49;3,4;29;2,0;20;1,4
3536703;Pederneiras;2018;72;1,6;52;1,2;20;0,4
3513603;Cunha;2018;40;1,8;25;1,2;15;0,7
3513702;Descalvado;2018;40;1,2;25;0,8;15;0,5
3550001;São Luiz do Paraitinga;2018;26;2,5;11;1,0;15;1,4
3500105;Adamantina;2018;258;7,6;219;6,5;39;1,2
3500709;Agudos;2018;60;1,7;38;1,1;22;0,6
3501608;Americana;2018;571;2,5;205;0,9;366;1,6
3501905;Amparo;2018;383;5,6;230;3,3;153;2,2
3502101;Andradina;2018;127;2,3;91;1,6;36;0,6
3502507;Aparecida;2018;104;2,9;70;2,0;34;1,0
3502804;Araçatuba;2018;367;1,9;305;1,6;62;0,3
3502903;Araçoiaba da Serra;2018;321;10,2;0;0,0;321;10,2
3503208;Araraquara;2018;443;2,0;216;1,0;227;1,0
3503307;Araras;2018;557;4,3;262;2,0;295;2,3
3503802;Artur Nogueira;2018;36;0,7;0;0,0;36;0,7
3503901;Arujá;2018;92;1,1;24;0,3;68;0,8
3504008;Assis;2018;285;2,8;160;1,6;125;1,2
3504107;Atibaia;2018;192;1,4;55;0,4;137;1,0
3504503;Avaré;2018;159;1,8;95;1,1;64;0,7
3505302;Barra Bonita;2018;91;2,6;59;1,7;32;0,9
3505500;Barretos;2018;504;4,3;391;3,3;113;1,0
3505708;Barueri;2018;429;1,7;353;1,4;76;0,3
3505906;Batatais;2018;133;2,2;101;1,7;32;0,5
3506003;Bauru;2018;1.159;3,2;612;1,7;547;1,5
3506102;Bebedouro;2018;140;1,9;75;1,0;65;0,9
3506508;Birigui;2018;168;1,4;88;0,7;80;0,7
3507001;Boituva;2018;53;1,0;36;0,6;17;0,3
3507506;Botucatu;2018;741;5,3;541;3,9;200;1,4
3507605;Bragança Paulista;2018;368;2,3;206;1,3;162;1,0
3508504;Caçapava;2018;118;1,3;68;0,8;50;0,6
3509007;Caieiras;2018;122;1,2;67;0,7;55;0,6
3509205;Cajamar;2018;155;2,1;55;0,7;100;1,3
3509403;Cajuru;2018;140;5,6;55;2,2;85;3,4
3509502;Campinas;2018;2.755;2,4;1.322;1,1;1.433;1,2
3510401;Capivari;2018;87;1,6;47;0,9;40;0,8
3510500;Caraguatatuba;2018;165;1,5;111;1,0;54;0,5
3510609;Carapicuíba;2018;270;0,7;220;0,6;50;0,1
3510807;Casa Branca;2018;372;12,7;356;12,2;16;0,5
3511102;Catanduva;2018;533;4,6;374;3,2;159;1,4
3511300;Cedral;2018;50;5,8;0;0,0;50;5,8
3512803;Cosmópolis;2018;112;1,6;60;0,9;52;0,8
3513009;Cotia;2018;553;2,3;111;0,5;442;1,9
3513405;Cruzeiro;2018;120;1,5;84;1,1;36;0,5
3513504;Cubatão;2018;118;0,9;66;0,5;52;0,4
3513801;Diadema;2018;634;1,6;555;1,4;79;0,2
3514403;Dracena;2018;143;3,2;108;2,4;35;0,8
3515186;Espírito Santo do Pinhal;2018;453;10,7;361;8,5;92;2,2
3515509;Fernandópolis;2018;135;2,0;84;1,3;51;0,8
3516200;Franca;2018;736;2,2;482;1,4;254;0,8
3516309;Francisco Morato;2018;147;0,9;98;0,6;49;0,3
3516408;Franco da Rocha;2018;693;4,7;611;4,1;82;0,6
3516705;Garça;2018;312;7,3;270;6,3;42;1,0
3518206;Guararapes;2018;74;2,3;48;1,5;26;0,8
3518404;Guaratinguetá;2018;244;2,1;156;1,3;88;0,8
3518701;Guarujá;2018;336;1,1;225;0,7;111;0,4
3518800;Guarulhos;2018;1.996;1,5;1.444;1,1;552;0,4
3519071;Hortolândia;2018;84;0,4;62;0,3;22;0,1
3519600;Ibitinga;2018;99;1,7;46;0,8;53;0,9
3520004;Igaraçu do Tietê;2018;63;2,6;0;0,0;63;2,6
3520442;Ilha Solteira;2018;116;4,5;74;2,9;42;1,6
3520509;Indaiatuba;2018;337;1,4;207;0,9;130;0,6
3520707;Indiaporã;2018;36;9,3;4;1,0;32;8,3
3522208;Itapecerica da Serra;2018;583;3,5;176;1,1;407;2,4
3522307;Itapetininga;2018;142;0,9;100;0,6;42;0,3
3522406;Itapeva;2018;145;1,6;103;1,1;42;0,5
3522505;Itapevi;2018;294;1,3;217;0,9;77;0,3
3522604;Itapira;2018;1.041;14,7;578;8,1;463;6,5
3522703;Itápolis;2018;76;1,8;46;1,1;30;0,7
3523404;Itatiba;2018;119;1,0;60;0,5;59;0,5
3523909;Itu;2018;458;2,7;426;2,6;32;0,2
3524006;Itupeva;2018;86;1,5;48;0,9;38;0,7
3524105;Ituverava;2018;121;3,0;55;1,4;66;1,7
3524303;Jaboticabal;2018;212;2,9;56;0,8;156;2,1
3524402;Jacareí;2018;395;1,8;167;0,7;228;1,0
3524501;Jaci;2018;216;32,2;150;22,3;66;9,8
3524808;Jales;2018;154;3,3;103;2,2;51;1,1
3525003;Jandira;2018;14;0,1;0;0,0;14;0,1
3525201;Jarinu;2018;49;1,7;17;0,6;32;1,1
3525300;Jaú;2018;905;6,3;715;5,0;190;1,3
3525706;José Bonifácio;2018;53;1,5;22;0,6;31;0,9
3525904;Jundiaí;2018;824;2,1;439;1,1;385;1,0
3526001;Junqueirópolis;2018;52;2,6;25;1,3;27;1,4
3526209;Juquitiba;2018;59;2,0;0;0,0;59;2,0
3526704;Leme;2018;141;1,4;77;0,8;64;0,6
3526803;Lençóis Paulista;2018;87;1,3;60;0,9;27;0,4
3526902;Limeira;2018;375;1,3;180;0,6;195;0,7
3527108;Lins;2018;448;6,0;344;4,6;104;1,4
3527207;Lorena;2018;164;1,9;85;1,0;79;0,9
3529005;Marília;2018;875;3,8;663;2,9;212;0,9
3529302;Matão;2018;162;2,0;92;1,2;70;0,9
3529401;Mauá;2018;401;0,9;246;0,5;155;0,3
3530508;Mococa;2018;135;2,0;88;1,3;47;0,7
3530607;Mogi das Cruzes;2018;898;2,1;601;1,4;297;0,7
3530706;Mogi Guaçu;2018;333;2,3;154;1,1;179;1,2
3530805;Mogi Mirim;2018;213;2,4;114;1,3;99;1,1
3531308;Monte Alto;2018;109;2,3;58;1,2;51;1,1
3531902;Morro Agudo;2018;45;1,4;31;1,0;14;0,4
3532603;Nhandeara;2018;129;12,0;35;3,2;94;8,7
3533007;Nova Granada;2018;62;3,0;19;0,9;43;2,1
3533502;Novo Horizonte;2018;105;2,7;35;0,9;70;1,8
3533908;Olímpia;2018;79;1,5;42;0,8;37;0,7
3534302;Orlândia;2018;98;2,3;60;1,4;38;0,9
3534401;Osasco;2018;916;1,4;589;0,9;327;0,5
3534609;Osvaldo Cruz;2018;73;2,3;59;1,9;14;0,4
3534708;Ourinhos;2018;166;1,5;83;0,8;83;0,8
3535408;Panorama;2018;36;2,4;35;2,3;1;0,1
3537008;Pedregulho;2018;82;5,1;59;3,6;23;1,4
3537305;Penápolis;2018;254;4,2;175;2,9;79;1,3
3537800;Piedade;2018;290;5,4;258;4,8;32;0,6
3538006;Pindamonhangaba;2018;201;1,3;127;0,8;74;0,5
3538709;Piracicaba;2018;757;2,0;331;0,9;426;1,1
3538907;Pirajuí;2018;299;12,9;78;3,4;221;9,5
3539004;Pirangi;2018;41;3,8;9;0,8;32;3,0
3539301;Pirassununga;2018;151;2,1;57;0,8;94;1,3
3540200;Pontal;2018;45;0,9;29;0,6;16;0,3
3540705;Porto Ferreira;2018;55;1,0;33;0,6;22;0,4
3541109;Presidente Alves;2018;120;29,7;0;0,0;120;29,7
3541406;Presidente Prudente;2018;1.028;4,7;676;3,1;352;1,6
3541505;Presidente Venceslau;2018;96;2,5;60;1,6;36;0,9
3542206;Rancharia;2018;103;3,6;71;2,5;32;1,1
3542602;Registro;2018;145;2,7;98;1,8;47;0,9
3543006;Ribeirão Branco;2018;36;2,0;35;2,0;1;0,1
3543303;Ribeirão Pires;2018;164;1,4;50;0,4;114;1,0
3543402;Ribeirão Preto;2018;2.188;3,3;1.415;2,1;773;1,2
3543907;Rio Claro;2018;392;2,0;190;1,0;202;1,0
3544202;Riolândia;2018;36;3,2;7;0,6;29;2,6
3544301;Roseira;2018;54;5,2;14;1,3;40;3,8
3545209;Salto;2018;116;1,0;62;0,5;54;0,5
3545308;Salto de Pirapora;2018;269;6,2;247;5,7;22;0,5
3545605;Santa Adélia;2018;24;1,6;7;0,5;17;1,1
3545803;Santa Bárbara d'Oeste;2018;168;0,9;97;0,5;71;0,4
3546405;Santa Cruz do Rio Pardo;2018;96;2,1;55;1,2;41;0,9
3546603;Santa Fé do Sul;2018;70;2,3;46;1,5;24;0,8
3547502;Santa Rita do Passa Quatro;2018;319;12,1;296;11,2;23;0,9
3547809;Santo André;2018;1.455;2,1;643;0,9;812;1,2
3548500;Santos;2018;1.738;4,1;874;2,0;864;2,0
3548609;São Bento do Sapucaí;2018;40;3,8;26;2,5;14;1,3
3548708;São Bernardo do Campo;2018;1.510;1,9;785;1,0;725;0,9
3548807;São Caetano do Sul;2018;591;3,9;183;1,2;408;2,7
3548906;São Carlos;2018;434;1,8;213;0,9;221;0,9
3549102;São João da Boa Vista;2018;199;2,3;94;1,1;105;1,2
3549409;São Joaquim da Barra;2018;115;2,3;68;1,4;47;0,9
3549706;São José do Rio Pardo;2018;136;2,6;81;1,5;55;1,0
3549805;São José do Rio Preto;2018;1.850;4,2;871;2,0;979;2,2
3549904;São José dos Campos;2018;1.645;2,4;869;1,3;776;1,1
3550308;São Paulo;2018;29.203;2,5;14.846;1,3;14.357;1,2
3550407;São Pedro;2018;62;1,8;37;1,1;25;0,7
3550605;São Roque;2018;88;1,0;49;0,6;39;0,5
3551009;São Vicente;2018;281;0,8;150;0,4;131;0,4
3551603;Serra Negra;2018;49;1,8;33;1,2;16;0,6
3551702;Sertãozinho;2018;162;1,3;66;0,5;96;0,8
3552205;Sorocaba;2018;1.414;2,2;845;1,3;569;0,9
3552502;Suzano;2018;150;0,5;67;0,2;83;0,3
3552809;Taboão da Serra;2018;495;1,8;334;1,2;161;0,6
3553708;Taquaritinga;2018;124;2,3;72;1,3;52;1,0
3554003;Tatuí;2018;147;1,3;92;0,8;55;0,5
3554102;Taubaté;2018;504;1,7;325;1,1;179;0,6
3554508;Tietê;2018;55;1,4;33;0,8;22;0,5
3555000;Tupã;2018;446;7,1;330;5,2;116;1,8
3556206;Valinhos;2018;142;1,2;57;0,5;85;0,7
3556305;Valparaíso;2018;55;2,3;31;1,3;24;1,0
3556404;Vargem Grande do Sul;2018;77;1,9;47;1,1;30;0,7
3556453;Vargem Grande Paulista;2018;70;1,4;2;0,0;68;1,3
3556602;Vera Cruz;2018;72;6,8;0;0,0;72;6,8
3556701;Vinhedo;2018;78;1,0;49;0,7;29;0,4
3557006;Votorantim;2018;177;1,5;53;0,5;124;1,1
3557105;Votuporanga;2018;205;2,3;115;1,3;90;1,0
3500501;Águas de Lindóia;2018;42;2,3;30;1,7;12;0,7
3511003;Castilho;2018;31;1,5;30;1,5;1;0,0
3516002;Flórida Paulista;2018;47;3,8;30;2,4;17;1,4
3529203;Martinópolis;2018;35;1,4;30;1,2;5;0,2
3530300;Mirassol;2018;81;1,4;30;0,5;51;0,9
3531407;Monte Aprazível;2018;80;3,5;30;1,3;50;2,2
3553401;Tanabi;2018;72;2,9;30;1,2;42;1,7
3554409;Terra Roxa;2018;34;3,8;30;3,3;4;0,4
3555109;Tupi Paulista;2018;48;3,2;30;2,0;18;1,2
3556800;Viradouro;2018;48;2,6;30;1,7;18;1,0
3557204;Chavantes;2018;50;4,1;30;2,5;20;1,6
3500204;Adolfo;2017;0;0,0;0;0,0;0;0,0
3500402;Águas da Prata;2017;0;0,0;0;0,0;0;0,0
3500550;Águas de Santa Bárbara;2017;0;0,0;0;0,0;0;0,0
3500600;Águas de São Pedro;2017;0;0,0;0;0,0;0;0,0
3500758;Alambari;2017;0;0,0;0;0,0;0;0,0
3500808;Alfredo Marcondes;2017;0;0,0;0;0,0;0;0,0
3500907;Altair;2017;0;0,0;0;0,0;0;0,0
3501152;Alumínio;2017;0;0,0;0;0,0;0;0,0
3501202;Álvares Florence;2017;0;0,0;0;0,0;0;0,0
3501400;Álvaro de Carvalho;2017;0;0,0;0;0,0;0;0,0
3501509;Alvinlândia;2017;0;0,0;0;0,0;0;0,0
3501806;Américo de Campos;2017;0;0,0;0;0,0;0;0,0
3502002;Analândia;2017;0;0,0;0;0,0;0;0,0
3502309;Anhembi;2017;0;0,0;0;0,0;0;0,0
3502408;Anhumas;2017;0;0,0;0;0,0;0;0,0
3502754;Araçariguama;2017;0;0,0;0;0,0;0;0,0
3503000;Aramina;2017;0;0,0;0;0,0;0;0,0
3503158;Arapeí;2017;0;0,0;0;0,0;0;0,0
3503356;Arco-Íris;2017;0;0,0;0;0,0;0;0,0
3503505;Areias;2017;0;0,0;0;0,0;0;0,0
3503604;Areiópolis;2017;0;0,0;0;0,0;0;0,0
3503950;Aspásia;2017;0;0,0;0;0,0;0;0,0
3504305;Avaí;2017;0;0,0;0;0,0;0;0,0
3504404;Avanhandava;2017;0;0,0;0;0,0;0;0,0
3504602;Bady Bassitt;2017;0;0,0;0;0,0;0;0,0
3504701;Balbinos;2017;0;0,0;0;0,0;0;0,0
3504800;Bálsamo;2017;0;0,0;0;0,0;0;0,0
3505005;Barão de Antonina;2017;0;0,0;0;0,0;0;0,0
3505104;Barbosa;2017;0;0,0;0;0,0;0;0,0
3505351;Barra do Chapéu;2017;0;0,0;0;0,0;0;0,0
3505401;Barra do Turvo;2017;0;0,0;0;0,0;0;0,0
3505609;Barrinha;2017;0;0,0;0;0,0;0;0,0
3506201;Bento de Abreu;2017;0;0,0;0;0,0;0;0,0
3506607;Biritiba Mirim;2017;0;0,0;0;0,0;0;0,0
3506904;Bofete;2017;0;0,0;0;0,0;0;0,0
3507159;Bom Sucesso de Itararé;2017;0;0,0;0;0,0;0;0,0
3507209;Borá;2017;0;0,0;0;0,0;0;0,0
3507308;Boracéia;2017;0;0,0;0;0,0;0;0,0
3507456;Borebi;2017;0;0,0;0;0,0;0;0,0
3507704;Braúna;2017;0;0,0;0;0,0;0;0,0
3507753;Brejo Alegre;2017;0;0,0;0;0,0;0;0,0
3507803;Brodowski;2017;0;0,0;0;0,0;0;0,0
3508009;Buri;2017;0;0,0;0;0,0;0;0,0
3508207;Buritizal;2017;0;0,0;0;0,0;0;0,0
3508306;Cabrália Paulista;2017;0;0,0;0;0,0;0;0,0
3508900;Caiabu;2017;0;0,0;0;0,0;0;0,0
3509106;Caiuá;2017;0;0,0;0;0,0;0;0,0
3509254;Cajati;2017;0;0,0;0;0,0;0;0,0
3509452;Campina do Monte Alegre;2017;0;0,0;0;0,0;0;0,0
3509809;Campos Novos Paulista;2017;0;0,0;0;0,0;0;0,0
3509908;Cananéia;2017;0;0,0;0;0,0;0;0,0
3509957;Canas;2017;0;0,0;0;0,0;0;0,0
3510104;Cândido Rodrigues;2017;0;0,0;0;0,0;0;0,0
3510153;Canitar;2017;0;0,0;0;0,0;0;0,0
3510906;Cássia dos Coqueiros;2017;0;0,0;0;0,0;0;0,0
3511201;Catiguá;2017;0;0,0;0;0,0;0;0,0
3512407;Cordeirópolis;2017;0;0,0;0;0,0;0;0,0
3512506;Coroados;2017;0;0,0;0;0,0;0;0,0
3512704;Corumbataí;2017;0;0,0;0;0,0;0;0,0
3512902;Cosmorama;2017;0;0,0;0;0,0;0;0,0
3513207;Cristais Paulista;2017;0;0,0;0;0,0;0;0,0
3513306;Cruzália;2017;0;0,0;0;0,0;0;0,0
3513850;Dirce Reis;2017;0;0,0;0;0,0;0;0,0
3514007;Dobrada;2017;0;0,0;0;0,0;0;0,0
3514205;Dolcinópolis;2017;0;0,0;0;0,0;0;0,0
3514601;Dumont;2017;0;0,0;0;0,0;0;0,0
3514700;Echaporã;2017;0;0,0;0;0,0;0;0,0
3514924;Elisiário;2017;0;0,0;0;0,0;0;0,0
3514957;Embaúba;2017;0;0,0;0;0,0;0;0,0
3515129;Emilianópolis;2017;0;0,0;0;0,0;0;0,0
3515152;Engenheiro Coelho;2017;0;0,0;0;0,0;0;0,0
3515194;Espírito Santo do Turvo;2017;0;0,0;0;0,0;0;0,0
3515301;Estrela do Norte;2017;0;0,0;0;0,0;0;0,0
3515350;Euclides da Cunha Paulista;2017;0;0,0;0;0,0;0;0,0
3515608;Fernando Prestes;2017;0;0,0;0;0,0;0;0,0
3515657;Fernão;2017;0;0,0;0;0,0;0;0,0
3515806;Flora Rica;2017;0;0,0;0;0,0;0;0,0
3515905;Floreal;2017;0;0,0;0;0,0;0;0,0
3516101;Florínea;2017;0;0,0;0;0,0;0;0,0
3516507;Gabriel Monteiro;2017;0;0,0;0;0,0;0;0,0
3516804;Gastão Vidigal;2017;0;0,0;0;0,0;0;0,0
3516853;Gavião Peixoto;2017;0;0,0;0;0,0;0;0,0
3517109;Glicério;2017;0;0,0;0;0,0;0;0,0
3517208;Guaiçara;2017;0;0,0;0;0,0;0;0,0
3517307;Guaimbê;2017;0;0,0;0;0,0;0;0,0
3517505;Guapiaçu;2017;0;0,0;0;0,0;0;0,0
3517901;Guaraci;2017;0;0,0;0;0,0;0;0,0
3518008;Guarani d'Oeste;2017;0;0,0;0;0,0;0;0,0
3518107;Guarantã;2017;0;0,0;0;0,0;0;0,0
3518503;Guareí;2017;0;0,0;0;0,0;0;0,0
3518859;Guatapará;2017;0;0,0;0;0,0;0;0,0
3518909;Guzolândia;2017;0;0,0;0;0,0;0;0,0
3519055;Holambra;2017;0;0,0;0;0,0;0;0,0
3519204;Iacri;2017;0;0,0;0;0,0;0;0,0
3519253;Iaras;2017;0;0,0;0;0,0;0;0,0
3519501;Ibirarema;2017;0;0,0;0;0,0;0;0,0
3519808;Icém;2017;0;0,0;0;0,0;0;0,0
3520426;Ilha Comprida;2017;0;0,0;0;0,0;0;0,0
3520608;Indiana;2017;0;0,0;0;0,0;0;0,0
3520806;Inúbia Paulista;2017;0;0,0;0;0,0;0;0,0
3521101;Ipeúna;2017;0;0,0;0;0,0;0;0,0
3521150;Ipiguá;2017;0;0,0;0;0,0;0;0,0
3521200;Iporanga;2017;0;0,0;0;0,0;0;0,0
3521408;Iracemápolis;2017;0;0,0;0;0,0;0;0,0
3521507;Irapuã;2017;0;0,0;0;0,0;0;0,0
3521606;Irapuru;2017;0;0,0;0;0,0;0;0,0
3522000;Itaju;2017;0;0,0;0;0,0;0;0,0
3522158;Itaoca;2017;0;0,0;0;0,0;0;0,0
3522653;Itapirapuã Paulista;2017;0;0,0;0;0,0;0;0,0
3523008;Itapura;2017;0;0,0;0;0,0;0;0,0
3523305;Itariri;2017;0;0,0;0;0,0;0;0,0
3523701;Itirapuã;2017;0;0,0;0;0,0;0;0,0
3523800;Itobi;2017;0;0,0;0;0,0;0;0,0
3524600;Jacupiranga;2017;0;0,0;0;0,0;0;0,0
3524907;Jambeiro;2017;0;0,0;0;0,0;0;0,0
3525102;Jardinópolis;2017;0;0,0;0;0,0;0;0,0
3525409;Jeriquara;2017;0;0,0;0;0,0;0;0,0
3525607;João Ramalho;2017;0;0,0;0;0,0;0;0,0
3525805;Júlio Mesquita;2017;0;0,0;0;0,0;0;0,0
3525854;Jumirim;2017;0;0,0;0;0,0;0;0,0
3526308;Lagoinha;2017;0;0,0;0;0,0;0;0,0
3526506;Lavínia;2017;0;0,0;0;0,0;0;0,0
3526605;Lavrinhas;2017;0;0,0;0;0,0;0;0,0
3527009;Lindóia;2017;0;0,0;0;0,0;0;0,0
3527256;Lourdes;2017;0;0,0;0;0,0;0;0,0
3527504;Lucianópolis;2017;0;0,0;0;0,0;0;0,0
3527603;Luís Antônio;2017;0;0,0;0;0,0;0;0,0
3527702;Luiziânia;2017;0;0,0;0;0,0;0;0,0
3527801;Lupércio;2017;0;0,0;0;0,0;0;0,0
3527900;Lutécia;2017;0;0,0;0;0,0;0;0,0
3528205;Macedônia;2017;0;0,0;0;0,0;0;0,0
3528304;Magda;2017;0;0,0;0;0,0;0;0,0
3528403;Mairinque;2017;0;0,0;0;0,0;0;0,0
3528601;Manduri;2017;0;0,0;0;0,0;0;0,0
3528700;Marabá Paulista;2017;0;0,0;0;0,0;0;0,0
3528858;Marapoama;2017;0;0,0;0;0,0;0;0,0
3528908;Mariápolis;2017;0;0,0;0;0,0;0;0,0
3529104;Marinópolis;2017;0;0,0;0;0,0;0;0,0
3529500;Mendonça;2017;0;0,0;0;0,0;0;0,0
3529609;Meridiano;2017;0;0,0;0;0,0;0;0,0
3529658;Mesópolis;2017;0;0,0;0;0,0;0;0,0
3529807;Mineiros do Tietê;2017;0;0,0;0;0,0;0;0,0
3529906;Miracatu;2017;0;0,0;0;0,0;0;0,0
3530003;Mira Estrela;2017;0;0,0;0;0,0;0;0,0
3530201;Mirante do Paranapanema;2017;0;0,0;0;0,0;0;0,0
3530409;Mirassolândia;2017;0;0,0;0;0,0;0;0,0
3530904;Mombuca;2017;0;0,0;0;0,0;0;0,0
3531001;Monções;2017;0;0,0;0;0,0;0;0,0
3531209;Monte Alegre do Sul;2017;0;0,0;0;0,0;0;0,0
3531605;Monte Castelo;2017;0;0,0;0;0,0;0;0,0
3531704;Monteiro Lobato;2017;0;0,0;0;0,0;0;0,0
3532058;Motuca;2017;0;0,0;0;0,0;0;0,0
3532108;Murutinga do Sul;2017;0;0,0;0;0,0;0;0,0
3532157;Nantes;2017;0;0,0;0;0,0;0;0,0
3532207;Narandiba;2017;0;0,0;0;0,0;0;0,0
3532306;Natividade da Serra;2017;0;0,0;0;0,0;0;0,0
3532702;Nipoã;2017;0;0,0;0;0,0;0;0,0
3532801;Nova Aliança;2017;0;0,0;0;0,0;0;0,0
3532827;Nova Campina;2017;0;0,0;0;0,0;0;0,0
3532843;Nova Canaã Paulista;2017;0;0,0;0;0,0;0;0,0
3532868;Nova Castilho;2017;0;0,0;0;0,0;0;0,0
3533106;Nova Guataporanga;2017;0;0,0;0;0,0;0;0,0
3533205;Nova Independência;2017;0;0,0;0;0,0;0;0,0
3533254;Novais;2017;0;0,0;0;0,0;0;0,0
3533304;Nova Luzitânia;2017;0;0,0;0;0,0;0;0,0
3533601;Nuporanga;2017;0;0,0;0;0,0;0;0,0
3533700;Ocauçu;2017;0;0,0;0;0,0;0;0,0
3533809;Óleo;2017;0;0,0;0;0,0;0;0,0
3534005;Onda Verde;2017;0;0,0;0;0,0;0;0,0
3534104;Oriente;2017;0;0,0;0;0,0;0;0,0
3534203;Orindiúva;2017;0;0,0;0;0,0;0;0,0
3534500;Oscar Bressane;2017;0;0,0;0;0,0;0;0,0
3534807;Ouro Verde;2017;0;0,0;0;0,0;0;0,0
3535002;Palestina;2017;0;0,0;0;0,0;0;0,0
3535101;Palmares Paulista;2017;0;0,0;0;0,0;0;0,0
3535606;Paraibuna;2017;0;0,0;0;0,0;0;0,0
3535705;Paraíso;2017;0;0,0;0;0,0;0;0,0
3535903;Paranapuã;2017;0;0,0;0;0,0;0;0,0
3536109;Pardinho;2017;0;0,0;0;0,0;0;0,0
3536257;Parisi;2017;0;0,0;0;0,0;0;0,0
3536406;Paulicéia;2017;0;0,0;0;0,0;0;0,0
3536570;Paulistânia;2017;0;0,0;0;0,0;0;0,0
3536802;Pedra Bela;2017;0;0,0;0;0,0;0;0,0
3536901;Pedranópolis;2017;0;0,0;0;0,0;0;0,0
3537156;Pedrinhas Paulista;2017;0;0,0;0;0,0;0;0,0
3537206;Pedro de Toledo;2017;0;0,0;0;0,0;0;0,0
3537503;Pereiras;2017;0;0,0;0;0,0;0;0,0
3537701;Piacatu;2017;0;0,0;0;0,0;0;0,0
3538105;Pindorama;2017;0;0,0;0;0,0;0;0,0
3538204;Pinhalzinho;2017;0;0,0;0;0,0;0;0,0
3538303;Piquerobi;2017;0;0,0;0;0,0;0;0,0
3538501;Piquete;2017;0;0,0;0;0,0;0;0,0
3539103;Pirapora do Bom Jesus;2017;0;0,0;0;0,0;0;0,0
3539202;Pirapozinho;2017;0;0,0;0;0,0;0;0,0
3539608;Planalto;2017;0;0,0;0;0,0;0;0,0
3539707;Platina;2017;0;0,0;0;0,0;0;0,0
3539905;Poloni;2017;0;0,0;0;0,0;0;0,0
3540101;Pongaí;2017;0;0,0;0;0,0;0;0,0
3540259;Pontalinda;2017;0;0,0;0;0,0;0;0,0
3540309;Pontes Gestal;2017;0;0,0;0;0,0;0;0,0
3540507;Porangaba;2017;0;0,0;0;0,0;0;0,0
3540754;Potim;2017;0;0,0;0;0,0;0;0,0
3540853;Pracinha;2017;0;0,0;0;0,0;0;0,0
3540903;Pradópolis;2017;0;0,0;0;0,0;0;0,0
3541059;Pratânia;2017;0;0,0;0;0,0;0;0,0
3541109;Presidente Alves;2017;0;0,0;0;0,0;0;0,0
3541653;Quadra;2017;0;0,0;0;0,0;0;0,0
3541703;Quatá;2017;0;0,0;0;0,0;0;0,0
3541802;Queiroz;2017;0;0,0;0;0,0;0;0,0
3542008;Quintana;2017;0;0,0;0;0,0;0;0,0
3542107;Rafard;2017;0;0,0;0;0,0;0;0,0
3542305;Redenção da Serra;2017;0;0,0;0;0,0;0;0,0
3542503;Reginópolis;2017;0;0,0;0;0,0;0;0,0
3542701;Restinga;2017;0;0,0;0;0,0;0;0,0
3542800;Ribeira;2017;0;0,0;0;0,0;0;0,0
3543105;Ribeirão Corrente;2017;0;0,0;0;0,0;0;0,0
3543204;Ribeirão do Sul;2017;0;0,0;0;0,0;0;0,0
3543238;Ribeirão dos Índios;2017;0;0,0;0;0,0;0;0,0
3543253;Ribeirão Grande;2017;0;0,0;0;0,0;0;0,0
3543501;Riversul;2017;0;0,0;0;0,0;0;0,0
3543600;Rifaina;2017;0;0,0;0;0,0;0;0,0
3543709;Rincão;2017;0;0,0;0;0,0;0;0,0
3544103;Rio Grande da Serra;2017;0;0,0;0;0,0;0;0,0
3544400;Rubiácea;2017;0;0,0;0;0,0;0;0,0
3544509;Rubinéia;2017;0;0,0;0;0,0;0;0,0
3544608;Sabino;2017;0;0,0;0;0,0;0;0,0
3544707;Sagres;2017;0;0,0;0;0,0;0;0,0
3544806;Sales;2017;0;0,0;0;0,0;0;0,0
3545100;Salmourão;2017;0;0,0;0;0,0;0;0,0
3545159;Saltinho;2017;0;0,0;0;0,0;0;0,0
3545506;Sandovalina;2017;0;0,0;0;0,0;0;0,0
3545704;Santa Albertina;2017;0;0,0;0;0,0;0;0,0
3546009;Santa Branca;2017;0;0,0;0;0,0;0;0,0
3546108;Santa Clara d'Oeste;2017;0;0,0;0;0,0;0;0,0
3546207;Santa Cruz da Conceição;2017;0;0,0;0;0,0;0;0,0
3546256;Santa Cruz da Esperança;2017;0;0,0;0;0,0;0;0,0
3546504;Santa Ernestina;2017;0;0,0;0;0,0;0;0,0
3546702;Santa Gertrudes;2017;0;0,0;0;0,0;0;0,0
3546900;Santa Lúcia;2017;0;0,0;0;0,0;0;0,0
3547106;Santa Mercedes;2017;0;0,0;0;0,0;0;0,0
3547205;Santana da Ponte Pensa;2017;0;0,0;0;0,0;0;0,0
3547403;Santa Rita d'Oeste;2017;0;0,0;0;0,0;0;0,0
3547650;Santa Salete;2017;0;0,0;0;0,0;0;0,0
3548005;Santo Antônio de Posse;2017;0;0,0;0;0,0;0;0,0
3548054;Santo Antônio do Aracanguá;2017;0;0,0;0;0,0;0;0,0
3548104;Santo Antônio do Jardim;2017;0;0,0;0;0,0;0;0,0
3548203;Santo Antônio do Pinhal;2017;0;0,0;0;0,0;0;0,0
3548302;Santo Expedito;2017;0;0,0;0;0,0;0;0,0
3548401;Santópolis do Aguapeí;2017;0;0,0;0;0,0;0;0,0
3549003;São Francisco;2017;0;0,0;0;0,0;0;0,0
3549201;São João das Duas Pontes;2017;0;0,0;0;0,0;0;0,0
3549250;São João de Iracema;2017;0;0,0;0;0,0;0;0,0
3549300;São João do Pau d'Alho;2017;0;0,0;0;0,0;0;0,0
3549508;São José da Bela Vista;2017;0;0,0;0;0,0;0;0,0
3549607;São José do Barreiro;2017;0;0,0;0;0,0;0;0,0
3549953;São Lourenço da Serra;2017;0;0,0;0;0,0;0;0,0
3550506;São Pedro do Turvo;2017;0;0,0;0;0,0;0;0,0
3551108;Sarapuí;2017;0;0,0;0;0,0;0;0,0
3551207;Sarutaiá;2017;0;0,0;0;0,0;0;0,0
3551306;Sebastianópolis do Sul;2017;0;0,0;0;0,0;0;0,0
3551405;Serra Azul;2017;0;0,0;0;0,0;0;0,0
3551801;Sete Barras;2017;0;0,0;0;0,0;0;0,0
3551900;Severínia;2017;0;0,0;0;0,0;0;0,0
3552551;Suzanápolis;2017;0;0,0;0;0,0;0;0,0
3552908;Taciba;2017;0;0,0;0;0,0;0;0,0
3553104;Taiaçu;2017;0;0,0;0;0,0;0;0,0
3553500;Tapiraí;2017;0;0,0;0;0,0;0;0,0
3553658;Taquaral;2017;0;0,0;0;0,0;0;0,0
3553856;Taquarivaí;2017;0;0,0;0;0,0;0;0,0
3553906;Tarabai;2017;0;0,0;0;0,0;0;0,0
3553955;Tarumã;2017;0;0,0;0;0,0;0;0,0
3554201;Tejupá;2017;0;0,0;0;0,0;0;0,0
3554607;Timburi;2017;0;0,0;0;0,0;0;0,0
3554656;Torre de Pedra;2017;0;0,0;0;0,0;0;0,0
3554755;Trabiju;2017;0;0,0;0;0,0;0;0,0
3554805;Tremembé;2017;0;0,0;0;0,0;0;0,0
3554904;Três Fronteiras;2017;0;0,0;0;0,0;0;0,0
3554953;Tuiuti;2017;0;0,0;0;0,0;0;0,0
3555208;Turiúba;2017;0;0,0;0;0,0;0;0,0
3555307;Turmalina;2017;0;0,0;0;0,0;0;0,0
3555356;Ubarana;2017;0;0,0;0;0,0;0;0,0
3555505;Ubirajara;2017;0;0,0;0;0,0;0;0,0
3555604;Uchoa;2017;0;0,0;0;0,0;0;0,0
3555703;União Paulista;2017;0;0,0;0;0,0;0;0,0
3555901;Uru;2017;0;0,0;0;0,0;0;0,0
3556107;Valentim Gentil;2017;0;0,0;0;0,0;0;0,0
3556354;Vargem;2017;0;0,0;0;0,0;0;0,0
3556909;Vista Alegre do Alto;2017;0;0,0;0;0,0;0;0,0
3556958;Vitória Brasil;2017;0;0,0;0;0,0;0;0,0
3557154;Zacarias;2017;0;0,0;0;0,0;0;0,0
3557303;Estiva Gerbi;2017;0;0,0;0;0,0;0;0,0
3501707;Américo Brasiliense;2017;220;5,7;220;5,7;0;0,0
3503109;Arandu;2017;16;2,6;16;2,6;0;0,0
3504909;Bananal;2017;15;1,4;15;1,4;0;0,0
3506359;Bertioga;2017;49;0,8;49;0,8;0;0,0
3506409;Bilac;2017;36;4,7;36;4,7;0;0,0
3507100;Bom Jesus dos Perdões;2017;11;0,5;11;0,5;0;0,0
3508702;Caconde;2017;62;3,3;62;3,3;0;0,0
3509601;Campo Limpo Paulista;2017;68;0,8;68;0,8;0;0,0
3510302;Capela do Alto;2017;14;0,7;14;0,7;0;0,0
3512100;Colômbia;2017;20;3,3;20;3,3;0;0,0
3512308;Conchas;2017;32;1,9;32;1,9;0;0,0
3512605;Coronel Macedo;2017;6;1,2;6;1,2;0;0,0
3513900;Divinolândia;2017;186;17,0;186;17,0;0;0,0
3514304;Dourado;2017;18;2,1;18;2,1;0;0,0
3514809;Eldorado;2017;2;0,1;2;0,1;0;0,0
3514908;Elias Fausto;2017;6;0,4;6;0,4;0;0,0
3515103;Embu-Guaçu;2017;16;0,2;16;0,2;0;0,0
3515707;Ferraz de Vasconcelos;2017;189;1,0;189;1,0;0;0,0
3517604;Guapiara;2017;19;1,1;19;1,1;0;0,0
3519006;Herculândia;2017;58;6,4;58;6,4;0;0,0
3519303;Ibaté;2017;32;1,0;32;1,0;0;0,0
3519907;Iepê;2017;20;2,6;20;2,6;0;0,0
3520202;Igaratá;2017;15;1,6;15;1,6;0;0,0
3520301;Iguape;2017;9;0,3;9;0,3;0;0,0
3521002;Iperó;2017;15;0,5;15;0,5;0;0,0
3521705;Itaberá;2017;35;2,0;35;2,0;0;0,0
3521804;Itaí;2017;35;1,4;35;1,4;0;0,0
3522109;Itanhaém;2017;77;0,8;77;0,8;0;0,0
3523107;Itaquaquecetuba;2017;224;0,6;224;0,6;0;0,0
3523602;Itirapina;2017;25;1,5;25;1,5;0;0,0
3524204;Jaborandi;2017;17;2,6;17;2,6;0;0,0
3525508;Joanópolis;2017;11;0,9;11;0,9;0;0,0
3526100;Juquiá;2017;15;0,8;15;0,8;0;0,0
3531100;Mongaguá;2017;48;0,9;48;0,9;0;0,0
3532405;Nazaré Paulista;2017;20;1,1;20;1,1;0;0,0
3533403;Nova Odessa;2017;53;0,9;53;0,9;0;0,0
3535804;Paranapanema;2017;30;1,6;30;1,6;0;0,0
3536208;Pariquera-Açu;2017;149;7,8;149;7,8;0;0,0
3536505;Paulínia;2017;85;0,9;85;0,9;0;0,0
3537107;Pedreira;2017;98;2,2;98;2,2;0;0,0
3537602;Peruíbe;2017;14;0,2;14;0,2;0;0,0
3539806;Poá;2017;35;0,3;35;0,3;0;0,0
3541604;Promissão;2017;58;1,5;58;1,5;0;0,0
3541901;Queluz;2017;38;3,1;38;3,1;0;0,0
3544251;Rosana;2017;57;3,0;57;3,0;0;0,0
3544301;Roseira;2017;14;1,4;14;1,4;0;0,0
3547007;Santa Maria da Serra;2017;6;1,0;6;1,0;0;0,0
3547304;Santana de Parnaíba;2017;35;0,3;35;0,3;0;0,0
3547908;Santo Antônio da Alegria;2017;21;3,2;21;3,2;0;0,0
3550209;São Miguel Arcanjo;2017;54;1,7;54;1,7;0;0,0
3552007;Silveiras;2017;3;0,5;3;0,5;0;0,0
3553203;Taiúva;2017;4;0,6;4;0,6;0;0,0
3500303;Aguaí;2017;10;0,3;0;0,0;10;0,3
3507407;Borborema;2017;26;1,7;16;1,1;10;0,7
3509700;Campos do Jordão;2017;201;4,1;191;3,9;10;0,2
3511904;Clementina;2017;30;3,8;20;2,5;10;1,3
3514502;Duartina;2017;87;7,2;77;6,4;10;0,8
3521309;Ipuã;2017;49;3,2;39;2,5;10;0,7
3521903;Itajobi;2017;30;2,1;20;1,4;10;0,7
3532009;Morungaba;2017;20;1,6;10;0,8;10;0,8
3535200;Palmeira d'Oeste;2017;20;2,2;10;1,1;10;1,1
3540408;Populina;2017;18;4,4;8;2,0;10;2,5
3541307;Presidente Epitácio;2017;78;1,9;68;1,6;10;0,2
3544905;Sales Oliveira;2017;29;2,6;19;1,7;10;0,9
3555406;Ubatuba;2017;81;0,9;71;0,8;10;0,1
3505807;Bastos;2017;35;1,7;28;1,4;7;0,3
3508603;Cachoeira Paulista;2017;47;1,5;40;1,3;7;0,2
3511706;Charqueada;2017;33;2,0;26;1,6;7;0,4
3518602;Guariba;2017;72;1,9;65;1,7;7;0,2
3523503;Itatinga;2017;14;0,7;7;0,4;7;0,4
3527306;Louveira;2017;34;0,8;27;0,6;7;0,2
3552106;Socorro;2017;70;1,8;63;1,6;7;0,2
3554706;Torrinha;2017;20;2,1;13;1,4;7;0,7
3501004;Altinópolis;2017;31;2,0;25;1,6;6;0,4
3502705;Apiaí;2017;51;2,1;45;1,8;6;0,2
3506805;Bocaina;2017;35;3,0;29;2,5;6;0,5
3507902;Brotas;2017;41;1,8;35;1,5;6;0,3
3509304;Cajobi;2017;32;3,2;26;2,6;6;0,6
3518305;Guararema;2017;35;1,2;29;1,0;6;0,2
3530102;Mirandópolis;2017;67;2,4;61;2,2;6;0,2
3536000;Parapuã;2017;32;3,0;26;2,5;6;0,6
3540002;Pompéia;2017;42;2,0;36;1,7;6;0,3
3542909;Ribeirão Bonito;2017;17;1,3;11;0,9;6;0,5
3554300;Teodoro Sampaio;2017;58;2,6;52;2,4;6;0,3
3511508;Cerquilho;2017;37;0,8;29;0,7;8;0,2
3515400;Fartura;2017;20;1,3;12;0,8;8;0,5
3517703;Guará;2017;30;1,5;22;1,1;8;0,4
3517802;Guaraçaí;2017;23;2,7;15;1,8;8;0,9
3537909;Pilar do Sul;2017;35;1,3;27;1,0;8;0,3
3538600;Piracaia;2017;37;1,4;29;1,1;8;0,3
3550704;São Sebastião;2017;101;1,2;93;1,1;8;0,1
3508405;Cabreúva;2017;16;0,3;11;0,2;5;0,1
3510005;Cândido Mota;2017;30;1,0;25;0,8;5;0,2
3512209;Conchal;2017;55;2,1;50;1,9;5;0,2
3515004;Embu das Artes;2017;94;0,4;89;0,3;5;0,0
3515202;Estrela d'Oeste;2017;50;6,1;45;5,5;5;0,6
3522901;Itapuí;2017;30;2,3;25;1,9;5;0,4
3527405;Lucélia;2017;15;0,7;10;0,5;5;0,2
3532900;Nova Europa;2017;12;1,2;7;0,7;5;0,5
3534757;Ouroeste;2017;33;3,5;28;3,0;5;0,5
3534906;Pacaembu;2017;37;2,8;32;2,4;5;0,4
3537404;Pereira Barreto;2017;52;2,1;47;1,9;5;0,2
3553005;Taguaí;2017;29;2,3;24;1,9;5;0,4
3553609;Tapiratiba;2017;24;1,9;19;1,5;5;0,4
3501301;Álvares Machado;2017;20;0,8;18;0,8;2;0,1
3502606;Aparecida d'Oeste;2017;22;5,2;20;4,7;2;0,5
3506706;Boa Esperança do Sul;2017;15;1,0;13;0,9;2;0,1
3513108;Cravinhos;2017;15;0,4;13;0,4;2;0,1
3519105;Iacanga;2017;30;2,7;28;2,6;2;0,2
3524709;Jaguariúna;2017;80;1,5;78;1,5;2;0,0
3545001;Salesópolis;2017;19;1,2;17;1,0;2;0,1
3552304;Sud Mennucci;2017;22;2,9;20;2,6;2;0,3
3555802;Urânia;2017;26;3,0;24;2,8;2;0,2
3522802;Itaporanga;2017;46;3,1;27;1,8;19;1,3
3529708;Miguelópolis;2017;66;3,1;47;2,2;19;0,9
3531506;Monte Azul Paulista;2017;70;3,8;51;2,8;19;1,0
3535507;Paraguaçu Paulista;2017;97;2,2;78;1,8;19;0,4
3538808;Piraju;2017;77;2,7;58;2,0;19;0,7
3546801;Santa Isabel;2017;101;1,9;82;1,5;19;0,4
3547700;Santo Anastácio;2017;56;2,8;37;1,8;19;0,9
3552601;Tabapuã;2017;30;2,6;11;0,9;19;1,6
3556404;Vargem Grande do Sul;2017;50;1,2;31;0,8;19;0,5
3510203;Capão Bonito;2017;67;1,4;49;1,1;18;0,4
3510708;Cardoso;2017;31;2,6;13;1,1;18;1,5
3511409;Cerqueira César;2017;52;2,8;34;1,8;18;1,0
3516606;Gália;2017;45;6,8;27;4,1;18;2,7
3517406;Guaíra;2017;60;1,6;42;1,1;18;0,5
3523206;Itararé;2017;96;2,0;78;1,6;18;0,4
3526407;Laranjal Paulista;2017;46;1,7;28;1,0;18;0,7
3535309;Palmital;2017;54;2,5;36;1,7;18;0,8
3539509;Pitangueiras;2017;50;1,3;32;0,9;18;0,5
3512001;Colina;2017;47;2,7;35;2,0;12;0,7
3516903;General Salgado;2017;32;3,0;20;1,9;12;1,1
3517000;Getulina;2017;48;4,4;36;3,3;12;1,1
3536307;Patrocínio Paulista;2017;35;2,5;23;1,6;12;0,9
3540606;Porto Feliz;2017;51;1,0;39;0,8;12;0,2
3545407;Salto Grande;2017;34;3,8;22;2,4;12;1,3
3547601;Santa Rosa de Viterbo;2017;30;1,2;18;0,7;12;0,5
3550902;São Simão;2017;50;3,4;38;2,6;12;0,8
3519709;Ibiúna;2017;67;0,9;63;0,8;4;0,1
3528809;Maracaí;2017;26;1,9;22;1,6;4;0,3
3550100;São Manuel;2017;35;0,9;31;0,8;4;0,1
3550803;São Sebastião da Grama;2017;30;2,5;26;2,2;4;0,3
3556503;Várzea Paulista;2017;35;0,3;31;0,3;4;0,0
3501103;Alto Alegre;2017;22;5,4;19;4,7;3;0,7
3502200;Angatuba;2017;57;2,4;54;2,3;3;0,1
3506300;Bernardino de Campos;2017;23;2,1;20;1,9;3;0,3
3520400;Ilhabela;2017;49;1,5;46;1,4;3;0,1
3528106;Macaubal;2017;18;2,3;15;1,9;3;0,4
3539400;Piratininga;2017;28;2,2;25;1,9;3;0,2
3540804;Potirendaba;2017;31;1,9;28;1,7;3;0,2
3542404;Regente Feijó;2017;16;0,8;13;0,7;3;0,2
3543808;Rinópolis;2017;23;2,4;20;2,0;3;0,3
3503406;Arealva;2017;28;3,5;17;2,1;11;1,4
3508801;Cafelândia;2017;58;3,4;47;2,8;11;0,6
3532504;Neves Paulista;2017;21;2,4;10;1,2;11;1,3
3541208;Presidente Bernardes;2017;51;3,7;40;2,9;11;0,8
3553302;Tambaú;2017;36;1,6;25;1,1;11;0,5
3511607;Cesário Lange;2017;30;1,8;17;1,0;13;0,8
3528007;Macatuba;2017;31;1,9;18;1,1;13;0,8
3541000;Praia Grande;2017;192;0,6;179;0,6;13;0,0
3552700;Tabatinga;2017;35;2,3;22;1,4;13;0,8
3503703;Ariranha;2017;25;2,7;4;0,4;21;2,3
3546306;Santa Cruz das Palmeiras;2017;46;1,4;25;0,8;21;0,6
3553807;Taquarituba;2017;53;2,3;32;1,4;21;0,9
3556008;Urupês;2017;34;2,6;13;1,0;21;1,6
3504206;Auriflama;2017;44;3,1;35;2,4;9;0,6
3526209;Juquitiba;2017;9;0,3;0;0,0;9;0,3
3529203;Martinópolis;2017;36;1,4;27;1,1;9;0,4
3531803;Monte Mor;2017;35;0,6;26;0,5;9;0,2
3552403;Sumaré;2017;181;0,7;172;0,6;9;0,0
3508108;Buritama;2017;42;2,6;22;1,4;20;1,2
3514106;Dois Córregos;2017;67;2,5;47;1,8;20;0,8
3520905;Ipaussu;2017;49;3,4;29;2,0;20;1,4
3525201;Jarinu;2017;37;1,3;17;0,6;20;0,7
3536703;Pederneiras;2017;72;1,6;52;1,2;20;0,5
3537008;Pedregulho;2017;75;4,7;55;3,4;20;1,2
3513603;Cunha;2017;40;1,8;25;1,2;15;0,7
3513702;Descalvado;2017;40;1,2;25;0,8;15;0,5
3536604;Paulo de Faria;2017;24;2,8;9;1,1;15;1,8
3550001;São Luiz do Paraitinga;2017;26;2,5;11;1,0;15;1,4
3551504;Serrana;2017;58;1,4;43;1,0;15;0,4
3500105;Adamantina;2017;258;7,6;219;6,5;39;1,2
3500709;Agudos;2017;60;1,7;38;1,1;22;0,6
3501608;Americana;2017;571;2,5;205;0,9;366;1,6
3501905;Amparo;2017;377;5,5;224;3,3;153;2,2
3502101;Andradina;2017;136;2,4;110;2,0;26;0,5
3502507;Aparecida;2017;104;2,9;70;2,0;34;1,0
3502804;Araçatuba;2017;479;2,5;333;1,8;146;0,8
3502903;Araçoiaba da Serra;2017;411;13,3;0;0,0;411;13,3
3503208;Araraquara;2017;443;2,0;216;1,0;227;1,0
3503307;Araras;2017;557;4,4;300;2,4;257;2,0
3503802;Artur Nogueira;2017;24;0,5;0;0,0;24;0,5
3503901;Arujá;2017;92;1,1;24;0,3;68;0,8
3504008;Assis;2017;280;2,8;159;1,6;121;1,2
3504107;Atibaia;2017;192;1,4;55;0,4;137;1,0
3504503;Avaré;2017;159;1,8;95;1,1;64;0,7
3505203;Bariri;2017;51;1,5;34;1,0;17;0,5
3505302;Barra Bonita;2017;101;2,9;68;1,9;33;0,9
3505500;Barretos;2017;513;4,4;425;3,6;88;0,8
3505708;Barueri;2017;499;1,9;351;1,4;148;0,6
3505906;Batatais;2017;133;2,2;101;1,7;32;0,5
3506003;Bauru;2017;1.161;3,2;612;1,7;549;1,5
3506102;Bebedouro;2017;124;1,7;75;1,0;49;0,7
3506508;Birigui;2017;168;1,4;88;0,7;80;0,7
3507001;Boituva;2017;53;1,0;36;0,7;17;0,3
3507506;Botucatu;2017;741;5,4;541;3,9;200;1,5
3507605;Bragança Paulista;2017;454;2,9;210;1,3;244;1,5
3508504;Caçapava;2017;139;1,6;63;0,7;76;0,8
3509007;Caieiras;2017;130;1,3;61;0,6;69;0,7
3509205;Cajamar;2017;155;2,1;55;0,7;100;1,4
3509403;Cajuru;2017;140;5,6;55;2,2;85;3,4
3509502;Campinas;2017;2.749;2,4;1.311;1,1;1.438;1,2
3510401;Capivari;2017;96;1,8;46;0,9;50;1,0
3510500;Caraguatatuba;2017;165;1,5;107;1,0;58;0,5
3510609;Carapicuíba;2017;270;0,7;220;0,6;50;0,1
3510807;Casa Branca;2017;372;12,8;356;12,2;16;0,5
3511102;Catanduva;2017;533;4,6;374;3,2;159;1,4
3511300;Cedral;2017;50;5,8;0;0,0;50;5,8
3512803;Cosmópolis;2017;90;1,3;0;0,0;90;1,3
3513009;Cotia;2017;503;2,2;111;0,5;392;1,7
3513405;Cruzeiro;2017;122;1,5;77;1,0;45;0,6
3513504;Cubatão;2017;118;0,9;66;0,5;52;0,4
3513801;Diadema;2017;624;1,6;545;1,4;79;0,2
3514403;Dracena;2017;143;3,2;108;2,4;35;0,8
3515186;Espírito Santo do Pinhal;2017;453;10,7;365;8,6;88;2,1
3515509;Fernandópolis;2017;135;2,1;84;1,3;51;0,8
3516200;Franca;2017;738;2,2;486;1,4;252;0,8
3516309;Francisco Morato;2017;147;0,9;98;0,6;49;0,3
3516408;Franco da Rocha;2017;672;4,6;590;4,0;82;0,6
3516705;Garça;2017;365;8,6;332;7,8;33;0,8
3518206;Guararapes;2017;74;2,3;48;1,5;26;0,8
3518404;Guaratinguetá;2017;244;2,1;156;1,3;88;0,8
3518701;Guarujá;2017;391;1,3;219;0,7;172;0,6
3518800;Guarulhos;2017;1.991;1,5;1.456;1,1;535;0,4
3519071;Hortolândia;2017;91;0,4;62;0,3;29;0,1
3519402;Ibirá;2017;27;2,3;10;0,9;17;1,4
3519600;Ibitinga;2017;99;1,7;52;0,9;47;0,8
3520004;Igaraçu do Tietê;2017;63;2,6;0;0,0;63;2,6
3520103;Igarapava;2017;60;2,1;32;1,1;28;1,0
3520442;Ilha Solteira;2017;116;4,5;74;2,9;42;1,6
3520509;Indaiatuba;2017;362;1,6;232;1,0;130;0,6
3520707;Indiaporã;2017;36;9,3;4;1,0;32;8,3
3522208;Itapecerica da Serra;2017;501;3,0;176;1,1;325;2,0
3522307;Itapetininga;2017;122;0,8;100;0,6;22;0,1
3522406;Itapeva;2017;145;1,6;103;1,1;42;0,5
3522505;Itapevi;2017;306;1,4;217;1,0;89;0,4
3522604;Itapira;2017;1.041;14,7;578;8,2;463;6,5
3522703;Itápolis;2017;76;1,8;46;1,1;30;0,7
3523404;Itatiba;2017;119;1,1;60;0,5;59;0,5
3523909;Itu;2017;463;2,8;423;2,6;40;0,2
3524006;Itupeva;2017;86;1,6;48;0,9;38;0,7
3524105;Ituverava;2017;121;3,0;55;1,4;66;1,7
3524303;Jaboticabal;2017;212;2,9;56;0,8;156;2,1
3524402;Jacareí;2017;389;1,7;161;0,7;228;1,0
3524501;Jaci;2017;216;32,8;150;22,8;66;10,0
3524808;Jales;2017;163;3,5;112;2,4;51;1,1
3525003;Jandira;2017;14;0,1;0;0,0;14;0,1
3525300;Jaú;2017;905;6,3;715;5,0;190;1,3
3525706;José Bonifácio;2017;61;1,7;28;0,8;33;0,9
3525904;Jundiaí;2017;812;2,0;440;1,1;372;0,9
3526001;Junqueirópolis;2017;51;2,6;25;1,3;26;1,3
3526704;Leme;2017;144;1,5;105;1,1;39;0,4
3526803;Lençóis Paulista;2017;87;1,3;60;0,9;27;0,4
3526902;Limeira;2017;405;1,4;200;0,7;205;0,7
3527108;Lins;2017;453;6,1;349;4,7;104;1,4
3527207;Lorena;2017;164;1,9;85;1,0;79;0,9
3528502;Mairiporã;2017;72;0,8;41;0,4;31;0,3
3529005;Marília;2017;742;3,3;564;2,5;178;0,8
3529302;Matão;2017;162;2,0;96;1,2;66;0,8
3529401;Mauá;2017;401;0,9;246;0,5;155;0,3
3530300;Mirassol;2017;78;1,4;29;0,5;49;0,9
3530508;Mococa;2017;135;2,0;86;1,3;49;0,7
3530607;Mogi das Cruzes;2017;763;1,8;601;1,4;162;0,4
3530706;Mogi Guaçu;2017;333;2,3;154;1,1;179;1,2
3530805;Mogi Mirim;2017;213;2,4;114;1,3;99;1,1
3531308;Monte Alto;2017;109;2,3;58;1,2;51;1,1
3531902;Morro Agudo;2017;45;1,4;31;1,0;14;0,4
3532603;Nhandeara;2017;129;12,0;35;3,2;94;8,7
3533007;Nova Granada;2017;62;3,0;19;0,9;43;2,1
3533502;Novo Horizonte;2017;105;2,7;35;0,9;70;1,8
3533908;Olímpia;2017;99;1,9;60;1,2;39;0,8
3534302;Orlândia;2017;98;2,4;59;1,4;39;0,9
3534401;Osasco;2017;1.000;1,5;591;0,9;409;0,6
3534609;Osvaldo Cruz;2017;73;2,3;59;1,9;14;0,4
3534708;Ourinhos;2017;169;1,6;83;0,8;86;0,8
3535408;Panorama;2017;36;2,4;35;2,3;1;0,1
3537305;Penápolis;2017;254;4,2;175;2,9;79;1,3
3537800;Piedade;2017;290;5,5;258;4,9;32;0,6
3538006;Pindamonhangaba;2017;201;1,3;127;0,8;74;0,5
3538709;Piracicaba;2017;715;1,9;282;0,7;433;1,1
3538907;Pirajuí;2017;285;12,3;78;3,4;207;8,9
3539004;Pirangi;2017;41;3,8;9;0,8;32;3,0
3539301;Pirassununga;2017;151;2,1;57;0,8;94;1,3
3540200;Pontal;2017;45;1,0;29;0,6;16;0,3
3540705;Porto Ferreira;2017;61;1,1;33;0,6;28;0,5
3541406;Presidente Prudente;2017;1.041;4,8;680;3,1;361;1,7
3541505;Presidente Venceslau;2017;96;2,5;60;1,6;36;0,9
3542206;Rancharia;2017;103;3,6;71;2,5;32;1,1
3542602;Registro;2017;110;2,0;68;1,3;42;0,8
3543006;Ribeirão Branco;2017;36;2,0;35;2,0;1;0,1
3543303;Ribeirão Pires;2017;164;1,4;50;0,4;114;1,0
3543402;Ribeirão Preto;2017;2.157;3,3;1.399;2,1;758;1,1
3543907;Rio Claro;2017;427;2,2;238;1,2;189;1,0
3544004;Rio das Pedras;2017;42;1,3;28;0,8;14;0,4
3544202;Riolândia;2017;36;3,2;7;0,6;29;2,6
3545209;Salto;2017;125;1,1;72;0,6;53;0,5
3545308;Salto de Pirapora;2017;669;15,5;389;9,0;280;6,5
3545605;Santa Adélia;2017;24;1,6;7;0,5;17;1,2
3545803;Santa Bárbara d'Oeste;2017;156;0,8;85;0,5;71;0,4
3546405;Santa Cruz do Rio Pardo;2017;100;2,2;65;1,4;35;0,8
3546603;Santa Fé do Sul;2017;70;2,3;53;1,7;17;0,6
3547502;Santa Rita do Passa Quatro;2017;319;12,1;296;11,2;23;0,9
3547809;Santo André;2017;1.317;1,9;669;1,0;648;0,9
3548500;Santos;2017;1.672;3,9;852;2,0;820;1,9
3548609;São Bento do Sapucaí;2017;40;3,8;26;2,5;14;1,3
3548708;São Bernardo do Campo;2017;1.558;1,9;593;0,7;965;1,2
3548807;São Caetano do Sul;2017;571;3,8;183;1,2;388;2,6
3548906;São Carlos;2017;450;1,9;231;1,0;219;0,9
3549102;São João da Boa Vista;2017;199;2,3;94;1,1;105;1,2
3549409;São Joaquim da Barra;2017;115;2,3;68;1,4;47;1,0
3549706;São José do Rio Pardo;2017;136;2,6;81;1,5;55;1,0
3549805;São José do Rio Preto;2017;1.856;4,2;870;2,0;986;2,3
3549904;São José dos Campos;2017;1.534;2,2;736;1,1;798;1,2
3550308;São Paulo;2017;29.203;2,5;15.166;1,3;14.037;1,2
3550407;São Pedro;2017;62;1,9;37;1,1;25;0,7
3550605;São Roque;2017;88;1,0;49;0,6;39;0,5
3551009;São Vicente;2017;283;0,8;166;0,5;117;0,3
3551603;Serra Negra;2017;49;1,8;33;1,2;16;0,6
3551702;Sertãozinho;2017;162;1,4;66;0,6;96;0,8
3552205;Sorocaba;2017;1.455;2,3;892;1,4;563;0,9
3552502;Suzano;2017;161;0,6;67;0,2;94;0,3
3552809;Taboão da Serra;2017;495;1,8;334;1,2;161;0,6
3553708;Taquaritinga;2017;124;2,3;73;1,3;51;0,9
3554003;Tatuí;2017;177;1,5;114;1,0;63;0,5
3554102;Taubaté;2017;493;1,6;325;1,1;168;0,6
3554508;Tietê;2017;57;1,4;34;0,9;23;0,6
3555000;Tupã;2017;440;7,0;373;5,9;67;1,1
3556206;Valinhos;2017;140;1,2;46;0,4;94;0,8
3556305;Valparaíso;2017;55;2,3;31;1,3;24;1,0
3556453;Vargem Grande Paulista;2017;40;0,8;0;0,0;40;0,8
3556602;Vera Cruz;2017;36;3,4;0;0,0;36;3,4
3556701;Vinhedo;2017;88;1,2;55;0,7;33;0,4
3557006;Votorantim;2017;172;1,5;88;0,8;84;0,7
3557105;Votuporanga;2017;204;2,3;115;1,3;89;1,0
3500501;Águas de Lindóia;2017;42;2,3;30;1,7;12;0,7
3511003;Castilho;2017;31;1,6;30;1,5;1;0,1
3516002;Flórida Paulista;2017;47;3,8;30;2,4;17;1,4
3531407;Monte Aprazível;2017;80;3,5;30;1,3;50;2,2
3553401;Tanabi;2017;72;2,9;30;1,2;42;1,7
3554409;Terra Roxa;2017;34;3,8;30;3,4;4;0,4
3555109;Tupi Paulista;2017;48;3,2;30;2,0;18;1,2
3556800;Viradouro;2017;48;2,7;30;1,7;18;1,0
3557204;Chavantes;2017;50;4,1;30;2,5;20;1,6
3500204;Adolfo;2016;0;0,0;0;0,0;0;0,0
3500402;Águas da Prata;2016;0;0,0;0;0,0;0;0,0
3500550;Águas de Santa Bárbara;2016;0;0,0;0;0,0;0;0,0
3500758;Alambari;2016;0;0,0;0;0,0;0;0,0
3500808;Alfredo Marcondes;2016;0;0,0;0;0,0;0;0,0
3500907;Altair;2016;0;0,0;0;0,0;0;0,0
3501152;Alumínio;2016;0;0,0;0;0,0;0;0,0
3501202;Álvares Florence;2016;0;0,0;0;0,0;0;0,0
3501400;Álvaro de Carvalho;2016;0;0,0;0;0,0;0;0,0
3501509;Alvinlândia;2016;0;0,0;0;0,0;0;0,0
3501806;Américo de Campos;2016;0;0,0;0;0,0;0;0,0
3502002;Analândia;2016;0;0,0;0;0,0;0;0,0
3502309;Anhembi;2016;0;0,0;0;0,0;0;0,0
3502408;Anhumas;2016;0;0,0;0;0,0;0;0,0
3502754;Araçariguama;2016;0;0,0;0;0,0;0;0,0
3503000;Aramina;2016;0;0,0;0;0,0;0;0,0
3503158;Arapeí;2016;0;0,0;0;0,0;0;0,0
3503356;Arco-Íris;2016;0;0,0;0;0,0;0;0,0
3503505;Areias;2016;0;0,0;0;0,0;0;0,0
3503604;Areiópolis;2016;0;0,0;0;0,0;0;0,0
3503950;Aspásia;2016;0;0,0;0;0,0;0;0,0
3504305;Avaí;2016;0;0,0;0;0,0;0;0,0
3504404;Avanhandava;2016;0;0,0;0;0,0;0;0,0
3504602;Bady Bassitt;2016;0;0,0;0;0,0;0;0,0
3504701;Balbinos;2016;0;0,0;0;0,0;0;0,0
3504800;Bálsamo;2016;0;0,0;0;0,0;0;0,0
3505005;Barão de Antonina;2016;0;0,0;0;0,0;0;0,0
3505104;Barbosa;2016;0;0,0;0;0,0;0;0,0
3505351;Barra do Chapéu;2016;0;0,0;0;0,0;0;0,0
3505401;Barra do Turvo;2016;0;0,0;0;0,0;0;0,0
3505609;Barrinha;2016;0;0,0;0;0,0;0;0,0
3506201;Bento de Abreu;2016;0;0,0;0;0,0;0;0,0
3506607;Biritiba Mirim;2016;0;0,0;0;0,0;0;0,0
3506904;Bofete;2016;0;0,0;0;0,0;0;0,0
3507159;Bom Sucesso de Itararé;2016;0;0,0;0;0,0;0;0,0
3507209;Borá;2016;0;0,0;0;0,0;0;0,0
3507308;Boracéia;2016;0;0,0;0;0,0;0;0,0
3507456;Borebi;2016;0;0,0;0;0,0;0;0,0
3507704;Braúna;2016;0;0,0;0;0,0;0;0,0
3507753;Brejo Alegre;2016;0;0,0;0;0,0;0;0,0
3507803;Brodowski;2016;0;0,0;0;0,0;0;0,0
3508009;Buri;2016;0;0,0;0;0,0;0;0,0
3508207;Buritizal;2016;0;0,0;0;0,0;0;0,0
3508306;Cabrália Paulista;2016;0;0,0;0;0,0;0;0,0
3508900;Caiabu;2016;0;0,0;0;0,0;0;0,0
3509106;Caiuá;2016;0;0,0;0;0,0;0;0,0
3509254;Cajati;2016;0;0,0;0;0,0;0;0,0
3509452;Campina do Monte Alegre;2016;0;0,0;0;0,0;0;0,0
3509809;Campos Novos Paulista;2016;0;0,0;0;0,0;0;0,0
3509908;Cananéia;2016;0;0,0;0;0,0;0;0,0
3509957;Canas;2016;0;0,0;0;0,0;0;0,0
3510104;Cândido Rodrigues;2016;0;0,0;0;0,0;0;0,0
3510153;Canitar;2016;0;0,0;0;0,0;0;0,0
3510906;Cássia dos Coqueiros;2016;0;0,0;0;0,0;0;0,0
3511201;Catiguá;2016;0;0,0;0;0,0;0;0,0
3512407;Cordeirópolis;2016;0;0,0;0;0,0;0;0,0
3512506;Coroados;2016;0;0,0;0;0,0;0;0,0
3512605;Coronel Macedo;2016;0;0,0;0;0,0;0;0,0
3512704;Corumbataí;2016;0;0,0;0;0,0;0;0,0
3512902;Cosmorama;2016;0;0,0;0;0,0;0;0,0
3513207;Cristais Paulista;2016;0;0,0;0;0,0;0;0,0
3513306;Cruzália;2016;0;0,0;0;0,0;0;0,0
3513850;Dirce Reis;2016;0;0,0;0;0,0;0;0,0
3514007;Dobrada;2016;0;0,0;0;0,0;0;0,0
3514205;Dolcinópolis;2016;0;0,0;0;0,0;0;0,0
3514601;Dumont;2016;0;0,0;0;0,0;0;0,0
3514700;Echaporã;2016;0;0,0;0;0,0;0;0,0
3514924;Elisiário;2016;0;0,0;0;0,0;0;0,0
3514957;Embaúba;2016;0;0,0;0;0,0;0;0,0
3515129;Emilianópolis;2016;0;0,0;0;0,0;0;0,0
3515152;Engenheiro Coelho;2016;0;0,0;0;0,0;0;0,0
3515194;Espírito Santo do Turvo;2016;0;0,0;0;0,0;0;0,0
3515301;Estrela do Norte;2016;0;0,0;0;0,0;0;0,0
3515350;Euclides da Cunha Paulista;2016;0;0,0;0;0,0;0;0,0
3515608;Fernando Prestes;2016;0;0,0;0;0,0;0;0,0
3515657;Fernão;2016;0;0,0;0;0,0;0;0,0
3515806;Flora Rica;2016;0;0,0;0;0,0;0;0,0
3515905;Floreal;2016;0;0,0;0;0,0;0;0,0
3516101;Florínea;2016;0;0,0;0;0,0;0;0,0
3516507;Gabriel Monteiro;2016;0;0,0;0;0,0;0;0,0
3516804;Gastão Vidigal;2016;0;0,0;0;0,0;0;0,0
3516853;Gavião Peixoto;2016;0;0,0;0;0,0;0;0,0
3517109;Glicério;2016;0;0,0;0;0,0;0;0,0
3517208;Guaiçara;2016;0;0,0;0;0,0;0;0,0
3517307;Guaimbê;2016;0;0,0;0;0,0;0;0,0
3517505;Guapiaçu;2016;0;0,0;0;0,0;0;0,0
3517901;Guaraci;2016;0;0,0;0;0,0;0;0,0
3518008;Guarani d'Oeste;2016;0;0,0;0;0,0;0;0,0
3518107;Guarantã;2016;0;0,0;0;0,0;0;0,0
3518503;Guareí;2016;0;0,0;0;0,0;0;0,0
3518859;Guatapará;2016;0;0,0;0;0,0;0;0,0
3518909;Guzolândia;2016;0;0,0;0;0,0;0;0,0
3519055;Holambra;2016;0;0,0;0;0,0;0;0,0
3519253;Iaras;2016;0;0,0;0;0,0;0;0,0
3519501;Ibirarema;2016;0;0,0;0;0,0;0;0,0
3519808;Icém;2016;0;0,0;0;0,0;0;0,0
3520426;Ilha Comprida;2016;0;0,0;0;0,0;0;0,0
3520608;Indiana;2016;0;0,0;0;0,0;0;0,0
3520806;Inúbia Paulista;2016;0;0,0;0;0,0;0;0,0
3521101;Ipeúna;2016;0;0,0;0;0,0;0;0,0
3521150;Ipiguá;2016;0;0,0;0;0,0;0;0,0
3521200;Iporanga;2016;0;0,0;0;0,0;0;0,0
3521408;Iracemápolis;2016;0;0,0;0;0,0;0;0,0
3521507;Irapuã;2016;0;0,0;0;0,0;0;0,0
3521606;Irapuru;2016;0;0,0;0;0,0;0;0,0
3522000;Itaju;2016;0;0,0;0;0,0;0;0,0
3522158;Itaoca;2016;0;0,0;0;0,0;0;0,0
3522653;Itapirapuã Paulista;2016;0;0,0;0;0,0;0;0,0
3523008;Itapura;2016;0;0,0;0;0,0;0;0,0
3523305;Itariri;2016;0;0,0;0;0,0;0;0,0
3523701;Itirapuã;2016;0;0,0;0;0,0;0;0,0
3523800;Itobi;2016;0;0,0;0;0,0;0;0,0
3524600;Jacupiranga;2016;0;0,0;0;0,0;0;0,0
3524907;Jambeiro;2016;0;0,0;0;0,0;0;0,0
3525102;Jardinópolis;2016;0;0,0;0;0,0;0;0,0
3525409;Jeriquara;2016;0;0,0;0;0,0;0;0,0
3525607;João Ramalho;2016;0;0,0;0;0,0;0;0,0
3525805;Júlio Mesquita;2016;0;0,0;0;0,0;0;0,0
3525854;Jumirim;2016;0;0,0;0;0,0;0;0,0
3526308;Lagoinha;2016;0;0,0;0;0,0;0;0,0
3526506;Lavínia;2016;0;0,0;0;0,0;0;0,0
3526605;Lavrinhas;2016;0;0,0;0;0,0;0;0,0
3527009;Lindóia;2016;0;0,0;0;0,0;0;0,0
3527256;Lourdes;2016;0;0,0;0;0,0;0;0,0
3527504;Lucianópolis;2016;0;0,0;0;0,0;0;0,0
3527603;Luís Antônio;2016;0;0,0;0;0,0;0;0,0
3527801;Lupércio;2016;0;0,0;0;0,0;0;0,0
3527900;Lutécia;2016;0;0,0;0;0,0;0;0,0
3528205;Macedônia;2016;0;0,0;0;0,0;0;0,0
3528304;Magda;2016;0;0,0;0;0,0;0;0,0
3528403;Mairinque;2016;0;0,0;0;0,0;0;0,0
3528601;Manduri;2016;0;0,0;0;0,0;0;0,0
3528700;Marabá Paulista;2016;0;0,0;0;0,0;0;0,0
3528858;Marapoama;2016;0;0,0;0;0,0;0;0,0
3528908;Mariápolis;2016;0;0,0;0;0,0;0;0,0
3529104;Marinópolis;2016;0;0,0;0;0,0;0;0,0
3529500;Mendonça;2016;0;0,0;0;0,0;0;0,0
3529609;Meridiano;2016;0;0,0;0;0,0;0;0,0
3529658;Mesópolis;2016;0;0,0;0;0,0;0;0,0
3529807;Mineiros do Tietê;2016;0;0,0;0;0,0;0;0,0
3529906;Miracatu;2016;0;0,0;0;0,0;0;0,0
3530003;Mira Estrela;2016;0;0,0;0;0,0;0;0,0
3530201;Mirante do Paranapanema;2016;0;0,0;0;0,0;0;0,0
3530409;Mirassolândia;2016;0;0,0;0;0,0;0;0,0
3530904;Mombuca;2016;0;0,0;0;0,0;0;0,0
3531001;Monções;2016;0;0,0;0;0,0;0;0,0
3531209;Monte Alegre do Sul;2016;0;0,0;0;0,0;0;0,0
3531605;Monte Castelo;2016;0;0,0;0;0,0;0;0,0
3531704;Monteiro Lobato;2016;0;0,0;0;0,0;0;0,0
3532058;Motuca;2016;0;0,0;0;0,0;0;0,0
3532108;Murutinga do Sul;2016;0;0,0;0;0,0;0;0,0
3532157;Nantes;2016;0;0,0;0;0,0;0;0,0
3532207;Narandiba;2016;0;0,0;0;0,0;0;0,0
3532306;Natividade da Serra;2016;0;0,0;0;0,0;0;0,0
3532702;Nipoã;2016;0;0,0;0;0,0;0;0,0
3532801;Nova Aliança;2016;0;0,0;0;0,0;0;0,0
3532827;Nova Campina;2016;0;0,0;0;0,0;0;0,0
3532843;Nova Canaã Paulista;2016;0;0,0;0;0,0;0;0,0
3532868;Nova Castilho;2016;0;0,0;0;0,0;0;0,0
3533106;Nova Guataporanga;2016;0;0,0;0;0,0;0;0,0
3533205;Nova Independência;2016;0;0,0;0;0,0;0;0,0
3533254;Novais;2016;0;0,0;0;0,0;0;0,0
3533304;Nova Luzitânia;2016;0;0,0;0;0,0;0;0,0
3533601;Nuporanga;2016;0;0,0;0;0,0;0;0,0
3533700;Ocauçu;2016;0;0,0;0;0,0;0;0,0
3533809;Óleo;2016;0;0,0;0;0,0;0;0,0
3534005;Onda Verde;2016;0;0,0;0;0,0;0;0,0
3534104;Oriente;2016;0;0,0;0;0,0;0;0,0
3534203;Orindiúva;2016;0;0,0;0;0,0;0;0,0
3534500;Oscar Bressane;2016;0;0,0;0;0,0;0;0,0
3534807;Ouro Verde;2016;0;0,0;0;0,0;0;0,0
3535002;Palestina;2016;0;0,0;0;0,0;0;0,0
3535101;Palmares Paulista;2016;0;0,0;0;0,0;0;0,0
3535606;Paraibuna;2016;0;0,0;0;0,0;0;0,0
3535705;Paraíso;2016;0;0,0;0;0,0;0;0,0
3535903;Paranapuã;2016;0;0,0;0;0,0;0;0,0
3536109;Pardinho;2016;0;0,0;0;0,0;0;0,0
3536257;Parisi;2016;0;0,0;0;0,0;0;0,0
3536406;Paulicéia;2016;0;0,0;0;0,0;0;0,0
3536570;Paulistânia;2016;0;0,0;0;0,0;0;0,0
3536802;Pedra Bela;2016;0;0,0;0;0,0;0;0,0
3536901;Pedranópolis;2016;0;0,0;0;0,0;0;0,0
3537156;Pedrinhas Paulista;2016;0;0,0;0;0,0;0;0,0
3537206;Pedro de Toledo;2016;0;0,0;0;0,0;0;0,0
3537503;Pereiras;2016;0;0,0;0;0,0;0;0,0
3537602;Peruíbe;2016;0;0,0;0;0,0;0;0,0
3537701;Piacatu;2016;0;0,0;0;0,0;0;0,0
3538105;Pindorama;2016;0;0,0;0;0,0;0;0,0
3538204;Pinhalzinho;2016;0;0,0;0;0,0;0;0,0
3538303;Piquerobi;2016;0;0,0;0;0,0;0;0,0
3538501;Piquete;2016;0;0,0;0;0,0;0;0,0
3539103;Pirapora do Bom Jesus;2016;0;0,0;0;0,0;0;0,0
3539202;Pirapozinho;2016;0;0,0;0;0,0;0;0,0
3539608;Planalto;2016;0;0,0;0;0,0;0;0,0
3539707;Platina;2016;0;0,0;0;0,0;0;0,0
3539905;Poloni;2016;0;0,0;0;0,0;0;0,0
3540101;Pongaí;2016;0;0,0;0;0,0;0;0,0
3540259;Pontalinda;2016;0;0,0;0;0,0;0;0,0
3540309;Pontes Gestal;2016;0;0,0;0;0,0;0;0,0
3540507;Porangaba;2016;0;0,0;0;0,0;0;0,0
3540754;Potim;2016;0;0,0;0;0,0;0;0,0
3540853;Pracinha;2016;0;0,0;0;0,0;0;0,0
3540903;Pradópolis;2016;0;0,0;0;0,0;0;0,0
3541059;Pratânia;2016;0;0,0;0;0,0;0;0,0
3541109;Presidente Alves;2016;0;0,0;0;0,0;0;0,0
3541653;Quadra;2016;0;0,0;0;0,0;0;0,0
3541703;Quatá;2016;0;0,0;0;0,0;0;0,0
3541802;Queiroz;2016;0;0,0;0;0,0;0;0,0
3542008;Quintana;2016;0;0,0;0;0,0;0;0,0
3542107;Rafard;2016;0;0,0;0;0,0;0;0,0
3542305;Redenção da Serra;2016;0;0,0;0;0,0;0;0,0
3542503;Reginópolis;2016;0;0,0;0;0,0;0;0,0
3542701;Restinga;2016;0;0,0;0;0,0;0;0,0
3542800;Ribeira;2016;0;0,0;0;0,0;0;0,0
3543105;Ribeirão Corrente;2016;0;0,0;0;0,0;0;0,0
3543204;Ribeirão do Sul;2016;0;0,0;0;0,0;0;0,0
3543238;Ribeirão dos Índios;2016;0;0,0;0;0,0;0;0,0
3543253;Ribeirão Grande;2016;0;0,0;0;0,0;0;0,0
3543501;Riversul;2016;0;0,0;0;0,0;0;0,0
3543600;Rifaina;2016;0;0,0;0;0,0;0;0,0
3543709;Rincão;2016;0;0,0;0;0,0;0;0,0
3544103;Rio Grande da Serra;2016;0;0,0;0;0,0;0;0,0
3544400;Rubiácea;2016;0;0,0;0;0,0;0;0,0
3544509;Rubinéia;2016;0;0,0;0;0,0;0;0,0
3544608;Sabino;2016;0;0,0;0;0,0;0;0,0
3544707;Sagres;2016;0;0,0;0;0,0;0;0,0
3544806;Sales;2016;0;0,0;0;0,0;0;0,0
3545100;Salmourão;2016;0;0,0;0;0,0;0;0,0
3545159;Saltinho;2016;0;0,0;0;0,0;0;0,0
3545506;Sandovalina;2016;0;0,0;0;0,0;0;0,0
3545704;Santa Albertina;2016;0;0,0;0;0,0;0;0,0
3546009;Santa Branca;2016;0;0,0;0;0,0;0;0,0
3546108;Santa Clara d'Oeste;2016;0;0,0;0;0,0;0;0,0
3546207;Santa Cruz da Conceição;2016;0;0,0;0;0,0;0;0,0
3546256;Santa Cruz da Esperança;2016;0;0,0;0;0,0;0;0,0
3546504;Santa Ernestina;2016;0;0,0;0;0,0;0;0,0
3546702;Santa Gertrudes;2016;0;0,0;0;0,0;0;0,0
3546900;Santa Lúcia;2016;0;0,0;0;0,0;0;0,0
3547106;Santa Mercedes;2016;0;0,0;0;0,0;0;0,0
3547205;Santana da Ponte Pensa;2016;0;0,0;0;0,0;0;0,0
3547403;Santa Rita d'Oeste;2016;0;0,0;0;0,0;0;0,0
3547650;Santa Salete;2016;0;0,0;0;0,0;0;0,0
3548005;Santo Antônio de Posse;2016;0;0,0;0;0,0;0;0,0
3548054;Santo Antônio do Aracanguá;2016;0;0,0;0;0,0;0;0,0
3548104;Santo Antônio do Jardim;2016;0;0,0;0;0,0;0;0,0
3548203;Santo Antônio do Pinhal;2016;0;0,0;0;0,0;0;0,0
3548302;Santo Expedito;2016;0;0,0;0;0,0;0;0,0
3548401;Santópolis do Aguapeí;2016;0;0,0;0;0,0;0;0,0
3549003;São Francisco;2016;0;0,0;0;0,0;0;0,0
3549201;São João das Duas Pontes;2016;0;0,0;0;0,0;0;0,0
3549250;São João de Iracema;2016;0;0,0;0;0,0;0;0,0
3549300;São João do Pau d'Alho;2016;0;0,0;0;0,0;0;0,0
3549508;São José da Bela Vista;2016;0;0,0;0;0,0;0;0,0
3549607;São José do Barreiro;2016;0;0,0;0;0,0;0;0,0
3549953;São Lourenço da Serra;2016;0;0,0;0;0,0;0;0,0
3550506;São Pedro do Turvo;2016;0;0,0;0;0,0;0;0,0
3551108;Sarapuí;2016;0;0,0;0;0,0;0;0,0
3551207;Sarutaiá;2016;0;0,0;0;0,0;0;0,0
3551306;Sebastianópolis do Sul;2016;0;0,0;0;0,0;0;0,0
3551405;Serra Azul;2016;0;0,0;0;0,0;0;0,0
3551801;Sete Barras;2016;0;0,0;0;0,0;0;0,0
3551900;Severínia;2016;0;0,0;0;0,0;0;0,0
3552551;Suzanápolis;2016;0;0,0;0;0,0;0;0,0
3552908;Taciba;2016;0;0,0;0;0,0;0;0,0
3553104;Taiaçu;2016;0;0,0;0;0,0;0;0,0
3553500;Tapiraí;2016;0;0,0;0;0,0;0;0,0
3553658;Taquaral;2016;0;0,0;0;0,0;0;0,0
3553856;Taquarivaí;2016;0;0,0;0;0,0;0;0,0
3553906;Tarabai;2016;0;0,0;0;0,0;0;0,0
3553955;Tarumã;2016;0;0,0;0;0,0;0;0,0
3554201;Tejupá;2016;0;0,0;0;0,0;0;0,0
3554607;Timburi;2016;0;0,0;0;0,0;0;0,0
3554656;Torre de Pedra;2016;0;0,0;0;0,0;0;0,0
3554755;Trabiju;2016;0;0,0;0;0,0;0;0,0
3554805;Tremembé;2016;0;0,0;0;0,0;0;0,0
3554904;Três Fronteiras;2016;0;0,0;0;0,0;0;0,0
3554953;Tuiuti;2016;0;0,0;0;0,0;0;0,0
3555208;Turiúba;2016;0;0,0;0;0,0;0;0,0
3555307;Turmalina;2016;0;0,0;0;0,0;0;0,0
3555356;Ubarana;2016;0;0,0;0;0,0;0;0,0
3555505;Ubirajara;2016;0;0,0;0;0,0;0;0,0
3555604;Uchoa;2016;0;0,0;0;0,0;0;0,0
3555703;União Paulista;2016;0;0,0;0;0,0;0;0,0
3555901;Uru;2016;0;0,0;0;0,0;0;0,0
3556107;Valentim Gentil;2016;0;0,0;0;0,0;0;0,0
3556354;Vargem;2016;0;0,0;0;0,0;0;0,0
3556453;Vargem Grande Paulista;2016;0;0,0;0;0,0;0;0,0
3556909;Vista Alegre do Alto;2016;0;0,0;0;0,0;0;0,0
3556958;Vitória Brasil;2016;0;0,0;0;0,0;0;0,0
3557154;Zacarias;2016;0;0,0;0;0,0;0;0,0
3557303;Estiva Gerbi;2016;0;0,0;0;0,0;0;0,0
3500600;Águas de São Pedro;2016;4;1,3;4;1,3;0;0,0
3501707;Américo Brasiliense;2016;230;6,0;230;6,0;0;0,0
3503109;Arandu;2016;16;2,6;16;2,6;0;0,0
3504909;Bananal;2016;15;1,4;15;1,4;0;0,0
3506359;Bertioga;2016;49;0,9;49;0,9;0;0,0
3506409;Bilac;2016;36;4,8;36;4,8;0;0,0
3507100;Bom Jesus dos Perdões;2016;11;0,5;11;0,5;0;0,0
3508702;Caconde;2016;62;3,3;62;3,3;0;0,0
3509601;Campo Limpo Paulista;2016;56;0,7;56;0,7;0;0,0
3510302;Capela do Alto;2016;14;0,7;14;0,7;0;0,0
3512100;Colômbia;2016;20;3,3;20;3,3;0;0,0
3512308;Conchas;2016;32;1,9;32;1,9;0;0,0
3513900;Divinolândia;2016;192;17,5;192;17,5;0;0,0
3514809;Eldorado;2016;2;0,1;2;0,1;0;0,0
3514908;Elias Fausto;2016;6;0,4;6;0,4;0;0,0
3515103;Embu-Guaçu;2016;16;0,2;16;0,2;0;0,0
3515707;Ferraz de Vasconcelos;2016;189;1,0;189;1,0;0;0,0
3517604;Guapiara;2016;19;1,1;19;1,1;0;0,0
3519006;Herculândia;2016;58;6,4;58;6,4;0;0,0
3519303;Ibaté;2016;32;1,0;32;1,0;0;0,0
3519907;Iepê;2016;20;2,6;20;2,6;0;0,0
3520202;Igaratá;2016;15;1,6;15;1,6;0;0,0
3520301;Iguape;2016;13;0,4;13;0,4;0;0,0
3521002;Iperó;2016;15;0,5;15;0,5;0;0,0
3521705;Itaberá;2016;35;2,0;35;2,0;0;0,0
3522109;Itanhaém;2016;77;0,8;77;0,8;0;0,0
3523107;Itaquaquecetuba;2016;224;0,6;224;0,6;0;0,0
3523602;Itirapina;2016;25;1,5;25;1,5;0;0,0
3524204;Jaborandi;2016;17;2,6;17;2,6;0;0,0
3526100;Juquiá;2016;15;0,8;15;0,8;0;0,0
3530102;Mirandópolis;2016;90;3,2;90;3,2;0;0,0
3531100;Mongaguá;2016;44;0,9;44;0,9;0;0,0
3532405;Nazaré Paulista;2016;24;1,4;24;1,4;0;0,0
3533403;Nova Odessa;2016;53;1,0;53;1,0;0;0,0
3535804;Paranapanema;2016;30;1,6;30;1,6;0;0,0
3536208;Pariquera-Açu;2016;151;8,0;151;8,0;0;0,0
3536505;Paulínia;2016;85;0,9;85;0,9;0;0,0
3537107;Pedreira;2016;98;2,2;98;2,2;0;0,0
3539806;Poá;2016;35;0,3;35;0,3;0;0,0
3541604;Promissão;2016;58;1,5;58;1,5;0;0,0
3541901;Queluz;2016;20;1,6;20;1,6;0;0,0
3544251;Rosana;2016;57;3,0;57;3,0;0;0,0
3544301;Roseira;2016;14;1,4;14;1,4;0;0,0
3547007;Santa Maria da Serra;2016;6;1,0;6;1,0;0;0,0
3547304;Santana de Parnaíba;2016;35;0,3;35;0,3;0;0,0
3547908;Santo Antônio da Alegria;2016;12;1,8;12;1,8;0;0,0
3550209;São Miguel Arcanjo;2016;42;1,3;42;1,3;0;0,0
3552007;Silveiras;2016;3;0,5;3;0,5;0;0,0
3552304;Sud Mennucci;2016;20;2,6;20;2,6;0;0,0
3553203;Taiúva;2016;4;0,6;4;0,6;0;0,0
3500303;Aguaí;2016;10;0,3;0;0,0;10;0,3
3507407;Borborema;2016;26;1,7;16;1,1;10;0,7
3511904;Clementina;2016;30;3,8;20;2,5;10;1,3
3514502;Duartina;2016;87;7,2;77;6,4;10;0,8
3521309;Ipuã;2016;49;3,2;39;2,6;10;0,7
3527405;Lucélia;2016;25;1,2;15;0,7;10;0,5
3532009;Morungaba;2016;20;1,6;10;0,8;10;0,8
3538907;Pirajuí;2016;299;12,9;289;12,5;10;0,4
3540408;Populina;2016;18;4,4;8;2,0;10;2,5
3541307;Presidente Epitácio;2016;78;1,9;68;1,6;10;0,2
3544905;Sales Oliveira;2016;29;2,6;19;1,7;10;0,9
3505807;Bastos;2016;35;1,7;28;1,4;7;0,3
3508603;Cachoeira Paulista;2016;47;1,5;40;1,3;7;0,2
3511706;Charqueada;2016;33;2,0;26;1,6;7;0,4
3518602;Guariba;2016;72;1,9;65;1,7;7;0,2
3523503;Itatinga;2016;14;0,7;7;0,4;7;0,4
3525508;Joanópolis;2016;24;1,9;17;1,4;7;0,6
3527306;Louveira;2016;36;0,8;29;0,7;7;0,2
3531803;Monte Mor;2016;36;0,7;29;0,5;7;0,1
3542404;Regente Feijó;2016;24;1,3;17;0,9;7;0,4
3550100;São Manuel;2016;43;1,1;36;0,9;7;0,2
3554706;Torrinha;2016;20;2,1;13;1,4;7;0,7
3501004;Altinópolis;2016;31;2,0;25;1,6;6;0,4
3502705;Apiaí;2016;51;2,1;45;1,8;6;0,2
3506805;Bocaina;2016;35;3,0;29;2,5;6;0,5
3507902;Brotas;2016;41;1,8;35;1,5;6;0,3
3509304;Cajobi;2016;32;3,2;26;2,6;6;0,6
3518305;Guararema;2016;35;1,3;29;1,0;6;0,2
3536000;Parapuã;2016;32;3,0;26;2,4;6;0,6
3540002;Pompéia;2016;42;2,0;36;1,7;6;0,3
3542909;Ribeirão Bonito;2016;17;1,3;11;0,9;6;0,5
3554300;Teodoro Sampaio;2016;58;2,6;52;2,4;6;0,3
3555406;Ubatuba;2016;80;0,9;74;0,9;6;0,1
3511508;Cerquilho;2016;37;0,8;29;0,7;8;0,2
3515400;Fartura;2016;20;1,3;12;0,8;8;0,5
3517703;Guará;2016;30;1,5;22;1,1;8;0,4
3517802;Guaraçaí;2016;23;2,7;15;1,8;8;0,9
3529203;Martinópolis;2016;51;2,0;43;1,7;8;0,3
3537909;Pilar do Sul;2016;35;1,3;27;1,0;8;0,3
3538600;Piracaia;2016;37;1,4;29;1,1;8;0,3
3550704;São Sebastião;2016;101;1,2;93;1,1;8;0,1
3552106;Socorro;2016;62;1,6;54;1,4;8;0,2
3510005;Cândido Mota;2016;30;1,0;25;0,8;5;0,2
3515004;Embu das Artes;2016;94;0,4;89;0,3;5;0,0
3522901;Itapuí;2016;30;2,3;25;1,9;5;0,4
3532900;Nova Europa;2016;12;1,2;7;0,7;5;0,5
3534757;Ouroeste;2016;33;3,6;28;3,0;5;0,5
3534906;Pacaembu;2016;37;2,8;32;2,4;5;0,4
3553005;Taguaí;2016;29;2,3;24;1,9;5;0,4
3553609;Tapiratiba;2016;24;1,9;19;1,5;5;0,4
3501301;Álvares Machado;2016;20;0,8;18;0,8;2;0,1
3506706;Boa Esperança do Sul;2016;15;1,1;13;0,9;2;0,1
3513108;Cravinhos;2016;15;0,4;13;0,4;2;0,1
3519105;Iacanga;2016;27;2,5;25;2,3;2;0,2
3524709;Jaguariúna;2016;80;1,6;78;1,5;2;0,0
3545001;Salesópolis;2016;19;1,2;17;1,0;2;0,1
3555802;Urânia;2016;26;3,0;24;2,8;2;0,2
3556503;Várzea Paulista;2016;35;0,3;33;0,3;2;0,0
3522802;Itaporanga;2016;46;3,1;27;1,8;19;1,3
3529708;Miguelópolis;2016;66;3,1;47;2,2;19;0,9
3531506;Monte Azul Paulista;2016;70;3,8;51;2,8;19;1,0
3535507;Paraguaçu Paulista;2016;97;2,2;78;1,8;19;0,4
3538808;Piraju;2016;77;2,7;58;2,0;19;0,7
3544004;Rio das Pedras;2016;47;1,4;28;0,9;19;0,6
3546801;Santa Isabel;2016;101;1,9;82;1,5;19;0,4
3547700;Santo Anastácio;2016;56;2,8;37;1,8;19;0,9
3556701;Vinhedo;2016;67;0,9;48;0,7;19;0,3
3509403;Cajuru;2016;73;2,9;55;2,2;18;0,7
3510203;Capão Bonito;2016;67;1,5;49;1,1;18;0,4
3510708;Cardoso;2016;31;2,6;13;1,1;18;1,5
3511409;Cerqueira César;2016;52;2,8;34;1,8;18;1,0
3517406;Guaíra;2016;60;1,6;42;1,1;18;0,5
3539509;Pitangueiras;2016;50;1,3;32;0,9;18;0,5
3503802;Artur Nogueira;2016;12;0,2;0;0,0;12;0,2
3512001;Colina;2016;47;2,7;35;2,0;12;0,7
3517000;Getulina;2016;48;4,4;36;3,3;12;1,1
3521903;Itajobi;2016;27;1,8;15;1,0;12;0,8
3536307;Patrocínio Paulista;2016;35;2,5;23;1,7;12;0,9
3540606;Porto Feliz;2016;51;1,0;39;0,8;12;0,2
3545407;Salto Grande;2016;34;3,8;22;2,5;12;1,3
3547601;Santa Rosa de Viterbo;2016;30;1,2;18;0,7;12;0,5
3550902;São Simão;2016;50;3,4;38;2,6;12;0,8
3508405;Cabreúva;2016;13;0,3;9;0,2;4;0,1
3513504;Cubatão;2016;145;1,2;141;1,1;4;0,0
3519204;Iacri;2016;19;3,0;15;2,4;4;0,6
3519709;Ibiúna;2016;67;0,9;63;0,8;4;0,1
3528809;Maracaí;2016;26;1,9;22;1,6;4;0,3
3550803;São Sebastião da Grama;2016;30;2,5;26;2,2;4;0,3
3501103;Alto Alegre;2016;22;5,4;19;4,7;3;0,7
3502200;Angatuba;2016;57;2,4;54;2,3;3;0,1
3514304;Dourado;2016;19;2,2;16;1,9;3;0,4
3520400;Ilhabela;2016;49;1,6;46;1,5;3;0,1
3521804;Itaí;2016;39;1,5;36;1,4;3;0,1
3528106;Macaubal;2016;18;2,3;15;1,9;3;0,4
3539400;Piratininga;2016;28;2,2;25;2,0;3;0,2
3540804;Potirendaba;2016;31;1,9;28;1,7;3;0,2
3543808;Rinópolis;2016;23;2,3;20;2,0;3;0,3
3503406;Arealva;2016;28;3,5;17;2,1;11;1,4
3508801;Cafelândia;2016;58;3,4;47;2,8;11;0,6
3512209;Conchal;2016;52;2,0;41;1,5;11;0,4
3535200;Palmeira d'Oeste;2016;20;2,2;9;1,0;11;1,2
3541208;Presidente Bernardes;2016;51;3,7;40;2,9;11;0,8
3553302;Tambaú;2016;36;1,6;25;1,1;11;0,5
3511607;Cesário Lange;2016;30;1,8;17;1,0;13;0,8
3528007;Macatuba;2016;31;1,9;18;1,1;13;0,8
3541000;Praia Grande;2016;192;0,6;179;0,6;13;0,0
3552700;Tabatinga;2016;35;2,3;22;1,4;13;0,8
3503703;Ariranha;2016;25;2,8;4;0,4;21;2,3
3516606;Gália;2016;45;6,7;24;3,6;21;3,1
3546306;Santa Cruz das Palmeiras;2016;46;1,4;25;0,8;21;0,7
3552601;Tabapuã;2016;30;2,6;9;0,8;21;1,8
3553807;Taquarituba;2016;53;2,3;32;1,4;21;0,9
3556008;Urupês;2016;34;2,6;13;1,0;21;1,6
3526209;Juquitiba;2016;9;0,3;0;0,0;9;0,3
3552403;Sumaré;2016;181;0,7;172;0,6;9;0,0
3508108;Buritama;2016;42;2,6;22;1,4;20;1,2
3514106;Dois Córregos;2016;67;2,6;47;1,8;20;0,8
3520905;Ipaussu;2016;49;3,5;29;2,0;20;1,4
3525201;Jarinu;2016;37;1,3;17;0,6;20;0,7
3536703;Pederneiras;2016;72;1,6;52;1,2;20;0,5
3537008;Pedregulho;2016;75;4,7;55;3,4;20;1,2
3513603;Cunha;2016;40;1,8;25;1,2;15;0,7
3513702;Descalvado;2016;40;1,3;25;0,8;15;0,5
3523206;Itararé;2016;97;2,0;82;1,7;15;0,3
3526407;Laranjal Paulista;2016;47;1,8;32;1,2;15;0,6
3536604;Paulo de Faria;2016;24;2,8;9;1,1;15;1,8
3550001;São Luiz do Paraitinga;2016;26;2,5;11;1,0;15;1,4
3551504;Serrana;2016;58;1,4;43;1,0;15;0,4
3500105;Adamantina;2016;279;8,2;240;7,1;39;1,2
3500709;Agudos;2016;60;1,7;38;1,1;22;0,6
3501608;Americana;2016;640;2,8;251;1,1;389;1,7
3501905;Amparo;2016;395;5,8;242;3,5;153;2,2
3502101;Andradina;2016;136;2,4;110;2,0;26;0,5
3502507;Aparecida;2016;104;2,9;70;2,0;34;1,0
3502606;Aparecida d'Oeste;2016;21;4,9;20;4,7;1;0,2
3502804;Araçatuba;2016;474;2,5;328;1,8;146;0,8
3502903;Araçoiaba da Serra;2016;351;11,6;0;0,0;351;11,6
3503208;Araraquara;2016;509;2,3;188;0,8;321;1,5
3503307;Araras;2016;557;4,4;300;2,4;257;2,0
3503901;Arujá;2016;92;1,1;24;0,3;68;0,8
3504008;Assis;2016;307;3,1;183;1,8;124;1,3
3504107;Atibaia;2016;192;1,4;55;0,4;137;1,0
3504503;Avaré;2016;159;1,9;95;1,1;64;0,7
3505203;Bariri;2016;68;2,1;52;1,6;16;0,5
3505302;Barra Bonita;2016;101;2,9;68;1,9;33;0,9
3505500;Barretos;2016;581;5,0;464;4,0;117;1,0
3505708;Barueri;2016;499;2,0;351;1,4;148;0,6
3505906;Batatais;2016;139;2,4;94;1,6;45;0,8
3506003;Bauru;2016;1.107;3,1;612;1,7;495;1,4
3506102;Bebedouro;2016;129;1,7;81;1,1;48;0,6
3506300;Bernardino de Campos;2016;50;4,6;20;1,9;30;2,8
3506508;Birigui;2016;146;1,3;66;0,6;80;0,7
3507001;Boituva;2016;53;1,0;36;0,7;17;0,3
3507506;Botucatu;2016;702;5,2;502;3,7;200;1,5
3507605;Bragança Paulista;2016;395;2,5;210;1,3;185;1,2
3508504;Caçapava;2016;151;1,7;73;0,8;78;0,9
3509007;Caieiras;2016;117;1,2;58;0,6;59;0,6
3509205;Cajamar;2016;155;2,1;55;0,8;100;1,4
3509502;Campinas;2016;2.918;2,6;1.332;1,2;1.586;1,4
3509700;Campos do Jordão;2016;297;6,0;250;5,1;47;1,0
3510401;Capivari;2016;96;1,8;46;0,9;50;1,0
3510500;Caraguatatuba;2016;165;1,5;107;1,0;58;0,5
3510609;Carapicuíba;2016;370;1,0;220;0,6;150;0,4
3510807;Casa Branca;2016;372;12,8;355;12,2;17;0,6
3511102;Catanduva;2016;535;4,6;374;3,2;161;1,4
3511300;Cedral;2016;30;3,5;0;0,0;30;3,5
3512803;Cosmópolis;2016;90;1,4;63;0,9;27;0,4
3513009;Cotia;2016;177;0,8;111;0,5;66;0,3
3513405;Cruzeiro;2016;120;1,5;77;1,0;43;0,5
3513801;Diadema;2016;624;1,6;555;1,4;69;0,2
3514403;Dracena;2016;143;3,2;108;2,4;35;0,8
3515186;Espírito Santo do Pinhal;2016;454;10,7;366;8,6;88;2,1
3515509;Fernandópolis;2016;130;2,0;84;1,3;46;0,7
3516200;Franca;2016;747;2,2;471;1,4;276;0,8
3516309;Francisco Morato;2016;147;0,9;98;0,6;49;0,3
3516408;Franco da Rocha;2016;692;4,8;610;4,2;82;0,6
3516705;Garça;2016;377;8,8;332;7,8;45;1,1
3516903;General Salgado;2016;32;3,0;8;0,7;24;2,2
3518404;Guaratinguetá;2016;272;2,3;162;1,4;110;0,9
3518701;Guarujá;2016;323;1,1;217;0,7;106;0,3
3518800;Guarulhos;2016;1.909;1,5;1.453;1,1;456;0,4
3519071;Hortolândia;2016;91;0,4;62;0,3;29;0,1
3519402;Ibirá;2016;25;2,2;8;0,7;17;1,5
3519600;Ibitinga;2016;99;1,8;46;0,8;53;0,9
3520004;Igaraçu do Tietê;2016;63;2,6;0;0,0;63;2,6
3520103;Igarapava;2016;60;2,1;32;1,1;28;1,0
3520442;Ilha Solteira;2016;116;4,5;74;2,9;42;1,6
3520509;Indaiatuba;2016;342;1,5;232;1,0;110;0,5
3520707;Indiaporã;2016;36;9,3;4;1,0;32;8,3
3522208;Itapecerica da Serra;2016;501;3,1;176;1,1;325;2,0
3522307;Itapetininga;2016;122;0,8;100;0,6;22;0,1
3522406;Itapeva;2016;159;1,8;117;1,3;42;0,5
3522505;Itapevi;2016;286;1,3;205;0,9;81;0,4
3522604;Itapira;2016;1.046;14,8;587;8,3;459;6,5
3522703;Itápolis;2016;76;1,9;46;1,1;30;0,7
3523404;Itatiba;2016;119;1,1;60;0,5;59;0,5
3523909;Itu;2016;385;2,4;345;2,1;40;0,2
3524006;Itupeva;2016;86;1,6;48;0,9;38;0,7
3524105;Ituverava;2016;121;3,0;55;1,4;66;1,7
3524303;Jaboticabal;2016;172;2,3;56;0,8;116;1,6
3524402;Jacareí;2016;440;2,0;211;1,0;229;1,0
3524501;Jaci;2016;191;29,5;150;23,2;41;6,3
3524808;Jales;2016;165;3,5;112;2,4;53;1,1
3525003;Jandira;2016;14;0,1;0;0,0;14;0,1
3525300;Jaú;2016;860;6,1;705;5,0;155;1,1
3525706;José Bonifácio;2016;61;1,8;28;0,8;33;1,0
3525904;Jundiaí;2016;796;2,0;386;1,0;410;1,0
3526001;Junqueirópolis;2016;52;2,7;26;1,3;26;1,3
3526704;Leme;2016;130;1,3;83;0,9;47;0,5
3526803;Lençóis Paulista;2016;81;1,3;54;0,8;27;0,4
3526902;Limeira;2016;398;1,4;199;0,7;199;0,7
3527108;Lins;2016;451;6,1;349;4,7;102;1,4
3527207;Lorena;2016;172;2,0;81;1,0;91;1,1
3527702;Luiziânia;2016;32;5,9;15;2,7;17;3,1
3528502;Mairiporã;2016;72;0,8;47;0,5;25;0,3
3529005;Marília;2016;890;3,9;709;3,1;181;0,8
3529302;Matão;2016;162;2,1;96;1,2;66;0,8
3529401;Mauá;2016;445;1,0;302;0,7;143;0,3
3530300;Mirassol;2016;78;1,4;29;0,5;49;0,9
3530508;Mococa;2016;135;2,0;86;1,3;49;0,7
3530607;Mogi das Cruzes;2016;759;1,8;636;1,5;123;0,3
3530706;Mogi Guaçu;2016;333;2,3;154;1,1;179;1,2
3530805;Mogi Mirim;2016;225;2,5;123;1,4;102;1,1
3531308;Monte Alto;2016;109;2,3;58;1,2;51;1,1
3531902;Morro Agudo;2016;45;1,4;31;1,0;14;0,5
3532504;Neves Paulista;2016;35;4,0;11;1,3;24;2,8
3532603;Nhandeara;2016;129;12,0;35;3,2;94;8,7
3533007;Nova Granada;2016;193;9,5;19;0,9;174;8,6
3533502;Novo Horizonte;2016;105;2,8;35;0,9;70;1,8
3533908;Olímpia;2016;99;1,9;63;1,2;36;0,7
3534302;Orlândia;2016;98;2,4;59;1,4;39;0,9
3534401;Osasco;2016;1.006;1,5;604;0,9;402;0,6
3534609;Osvaldo Cruz;2016;90;2,9;59;1,9;31;1,0
3534708;Ourinhos;2016;185;1,7;83;0,8;102;0,9
3535309;Palmital;2016;68;3,2;44;2,1;24;1,1
3535408;Panorama;2016;36;2,4;35;2,3;1;0,1
3537305;Penápolis;2016;220;3,7;150;2,5;70;1,2
3537404;Pereira Barreto;2016;92;3,6;62;2,5;30;1,2
3537800;Piedade;2016;525;9,9;406;7,7;119;2,2
3538006;Pindamonhangaba;2016;201;1,3;127;0,8;74;0,5
3538709;Piracicaba;2016;704;1,9;315;0,8;389;1,0
3539004;Pirangi;2016;41;3,8;9;0,8;32;3,0
3539301;Pirassununga;2016;94;1,3;57;0,8;37;0,5
3540200;Pontal;2016;45;1,0;29;0,6;16;0,3
3540705;Porto Ferreira;2016;61;1,1;33;0,6;28;0,5
3541406;Presidente Prudente;2016;1.138;5,3;760;3,5;378;1,7
3541505;Presidente Venceslau;2016;99;2,6;57;1,5;42;1,1
3542206;Rancharia;2016;98;3,4;70;2,4;28;1,0
3542602;Registro;2016;115;2,1;63;1,2;52;1,0
3543006;Ribeirão Branco;2016;36;2,0;35;2,0;1;0,1
3543303;Ribeirão Pires;2016;164;1,4;50;0,4;114;1,0
3543402;Ribeirão Preto;2016;2.160;3,3;1.405;2,1;755;1,2
3543907;Rio Claro;2016;477;2,4;267;1,4;210;1,1
3544202;Riolândia;2016;36;3,2;7;0,6;29;2,6
3545209;Salto;2016;125;1,1;72;0,6;53;0,5
3545308;Salto de Pirapora;2016;921;21,6;723;16,9;198;4,6
3545605;Santa Adélia;2016;24;1,6;7;0,5;17;1,2
3545803;Santa Bárbara d'Oeste;2016;146;0,8;73;0,4;73;0,4
3546405;Santa Cruz do Rio Pardo;2016;100;2,2;65;1,4;35;0,8
3546603;Santa Fé do Sul;2016;68;2,3;33;1,1;35;1,2
3547502;Santa Rita do Passa Quatro;2016;299;11,3;276;10,4;23;0,9
3547809;Santo André;2016;1.335;1,9;684;1,0;651;0,9
3548500;Santos;2016;1.644;3,9;814;1,9;830;2,0
3548609;São Bento do Sapucaí;2016;40;3,8;26;2,5;14;1,3
3548708;São Bernardo do Campo;2016;1.543;1,9;560;0,7;983;1,2
3548807;São Caetano do Sul;2016;426;2,8;184;1,2;242;1,6
3548906;São Carlos;2016;417;1,8;198;0,8;219;0,9
3549102;São João da Boa Vista;2016;199;2,3;94;1,1;105;1,2
3549409;São Joaquim da Barra;2016;115;2,4;68;1,4;47;1,0
3549706;São José do Rio Pardo;2016;136;2,6;81;1,5;55;1,0
3549805;São José do Rio Preto;2016;1.820;4,2;916;2,1;904;2,1
3549904;São José dos Campos;2016;1.502;2,2;736;1,1;766;1,1
3550308;São Paulo;2016;28.766;2,5;15.147;1,3;13.619;1,2
3550407;São Pedro;2016;62;1,9;37;1,1;25;0,8
3550605;São Roque;2016;89;1,1;41;0,5;48;0,6
3551009;São Vicente;2016;283;0,8;166;0,5;117;0,3
3551603;Serra Negra;2016;49;1,8;33;1,2;16;0,6
3551702;Sertãozinho;2016;157;1,3;64;0,5;93;0,8
3552205;Sorocaba;2016;1.572;2,5;1.021;1,6;551;0,9
3552502;Suzano;2016;184;0,7;84;0,3;100;0,4
3552809;Taboão da Serra;2016;387;1,4;334;1,2;53;0,2
3553708;Taquaritinga;2016;124;2,3;73;1,3;51;0,9
3554003;Tatuí;2016;179;1,6;91;0,8;88;0,8
3554102;Taubaté;2016;479;1,6;325;1,1;154;0,5
3554508;Tietê;2016;69;1,7;42;1,1;27;0,7
3555000;Tupã;2016;640;10,1;571;9,1;69;1,1
3556206;Valinhos;2016;169;1,4;63;0,5;106;0,9
3556305;Valparaíso;2016;55;2,3;31;1,3;24;1,0
3556404;Vargem Grande do Sul;2016;77;1,9;47;1,2;30;0,7
3556602;Vera Cruz;2016;36;3,4;0;0,0;36;3,4
3557006;Votorantim;2016;172;1,5;88;0,8;84;0,7
3557105;Votuporanga;2016;204;2,3;115;1,3;89;1,0
3500501;Águas de Lindóia;2016;42;2,3;30;1,7;12;0,7
3504206;Auriflama;2016;51;3,5;30;2,1;21;1,5
3511003;Castilho;2016;31;1,6;30;1,5;1;0,1
3515202;Estrela d'Oeste;2016;50;6,1;30;3,7;20;2,5
3516002;Flórida Paulista;2016;47;3,8;30;2,4;17;1,4
3518206;Guararapes;2016;74;2,3;30;1,0;44;1,4
3531407;Monte Aprazível;2016;80;3,5;30;1,3;50;2,2
3553401;Tanabi;2016;72;2,9;30;1,2;42;1,7
3554409;Terra Roxa;2016;34;3,8;30;3,4;4;0,5
3555109;Tupi Paulista;2016;48;3,2;30;2,0;18;1,2
3556800;Viradouro;2016;48;2,7;30;1,7;18;1,0
3557204;Chavantes;2016;50;4,1;30;2,5;20;1,6
3500204;Adolfo;2015;0;0,0;0;0,0;0;0,0
3500303;Aguaí;2015;0;0,0;0;0,0;0;0,0
3500402;Águas da Prata;2015;0;0,0;0;0,0;0;0,0
3500550;Águas de Santa Bárbara;2015;0;0,0;0;0,0;0;0,0
3500758;Alambari;2015;0;0,0;0;0,0;0;0,0
3500808;Alfredo Marcondes;2015;0;0,0;0;0,0;0;0,0
3500907;Altair;2015;0;0,0;0;0,0;0;0,0
3501152;Alumínio;2015;0;0,0;0;0,0;0;0,0
3501202;Álvares Florence;2015;0;0,0;0;0,0;0;0,0
3501400;Álvaro de Carvalho;2015;0;0,0;0;0,0;0;0,0
3501509;Alvinlândia;2015;0;0,0;0;0,0;0;0,0
3501806;Américo de Campos;2015;0;0,0;0;0,0;0;0,0
3502002;Analândia;2015;0;0,0;0;0,0;0;0,0
3502309;Anhembi;2015;0;0,0;0;0,0;0;0,0
3502408;Anhumas;2015;0;0,0;0;0,0;0;0,0
3502754;Araçariguama;2015;0;0,0;0;0,0;0;0,0
3503000;Aramina;2015;0;0,0;0;0,0;0;0,0
3503158;Arapeí;2015;0;0,0;0;0,0;0;0,0
3503356;Arco-Íris;2015;0;0,0;0;0,0;0;0,0
3503505;Areias;2015;0;0,0;0;0,0;0;0,0
3503604;Areiópolis;2015;0;0,0;0;0,0;0;0,0
3503950;Aspásia;2015;0;0,0;0;0,0;0;0,0
3504305;Avaí;2015;0;0,0;0;0,0;0;0,0
3504404;Avanhandava;2015;0;0,0;0;0,0;0;0,0
3504602;Bady Bassitt;2015;0;0,0;0;0,0;0;0,0
3504701;Balbinos;2015;0;0,0;0;0,0;0;0,0
3504800;Bálsamo;2015;0;0,0;0;0,0;0;0,0
3505005;Barão de Antonina;2015;0;0,0;0;0,0;0;0,0
3505104;Barbosa;2015;0;0,0;0;0,0;0;0,0
3505351;Barra do Chapéu;2015;0;0,0;0;0,0;0;0,0
3505401;Barra do Turvo;2015;0;0,0;0;0,0;0;0,0
3505609;Barrinha;2015;0;0,0;0;0,0;0;0,0
3506201;Bento de Abreu;2015;0;0,0;0;0,0;0;0,0
3506607;Biritiba Mirim;2015;0;0,0;0;0,0;0;0,0
3506904;Bofete;2015;0;0,0;0;0,0;0;0,0
3507159;Bom Sucesso de Itararé;2015;0;0,0;0;0,0;0;0,0
3507209;Borá;2015;0;0,0;0;0,0;0;0,0
3507308;Boracéia;2015;0;0,0;0;0,0;0;0,0
3507456;Borebi;2015;0;0,0;0;0,0;0;0,0
3507704;Braúna;2015;0;0,0;0;0,0;0;0,0
3507753;Brejo Alegre;2015;0;0,0;0;0,0;0;0,0
3507803;Brodowski;2015;0;0,0;0;0,0;0;0,0
3508009;Buri;2015;0;0,0;0;0,0;0;0,0
3508207;Buritizal;2015;0;0,0;0;0,0;0;0,0
3508306;Cabrália Paulista;2015;0;0,0;0;0,0;0;0,0
3508900;Caiabu;2015;0;0,0;0;0,0;0;0,0
3509106;Caiuá;2015;0;0,0;0;0,0;0;0,0
3509452;Campina do Monte Alegre;2015;0;0,0;0;0,0;0;0,0
3509809;Campos Novos Paulista;2015;0;0,0;0;0,0;0;0,0
3509908;Cananéia;2015;0;0,0;0;0,0;0;0,0
3509957;Canas;2015;0;0,0;0;0,0;0;0,0
3510104;Cândido Rodrigues;2015;0;0,0;0;0,0;0;0,0
3510153;Canitar;2015;0;0,0;0;0,0;0;0,0
3510302;Capela do Alto;2015;0;0,0;0;0,0;0;0,0
3510906;Cássia dos Coqueiros;2015;0;0,0;0;0,0;0;0,0
3511201;Catiguá;2015;0;0,0;0;0,0;0;0,0
3512407;Cordeirópolis;2015;0;0,0;0;0,0;0;0,0
3512506;Coroados;2015;0;0,0;0;0,0;0;0,0
3512605;Coronel Macedo;2015;0;0,0;0;0,0;0;0,0
3512704;Corumbataí;2015;0;0,0;0;0,0;0;0,0
3512902;Cosmorama;2015;0;0,0;0;0,0;0;0,0
3513207;Cristais Paulista;2015;0;0,0;0;0,0;0;0,0
3513306;Cruzália;2015;0;0,0;0;0,0;0;0,0
3513850;Dirce Reis;2015;0;0,0;0;0,0;0;0,0
3514007;Dobrada;2015;0;0,0;0;0,0;0;0,0
3514205;Dolcinópolis;2015;0;0,0;0;0,0;0;0,0
3514601;Dumont;2015;0;0,0;0;0,0;0;0,0
3514700;Echaporã;2015;0;0,0;0;0,0;0;0,0
3514924;Elisiário;2015;0;0,0;0;0,0;0;0,0
3514957;Embaúba;2015;0;0,0;0;0,0;0;0,0
3515129;Emilianópolis;2015;0;0,0;0;0,0;0;0,0
3515152;Engenheiro Coelho;2015;0;0,0;0;0,0;0;0,0
3515194;Espírito Santo do Turvo;2015;0;0,0;0;0,0;0;0,0
3515301;Estrela do Norte;2015;0;0,0;0;0,0;0;0,0
3515350;Euclides da Cunha Paulista;2015;0;0,0;0;0,0;0;0,0
3515608;Fernando Prestes;2015;0;0,0;0;0,0;0;0,0
3515657;Fernão;2015;0;0,0;0;0,0;0;0,0
3515806;Flora Rica;2015;0;0,0;0;0,0;0;0,0
3515905;Floreal;2015;0;0,0;0;0,0;0;0,0
3516101;Florínea;2015;0;0,0;0;0,0;0;0,0
3516507;Gabriel Monteiro;2015;0;0,0;0;0,0;0;0,0
3516804;Gastão Vidigal;2015;0;0,0;0;0,0;0;0,0
3516853;Gavião Peixoto;2015;0;0,0;0;0,0;0;0,0
3517109;Glicério;2015;0;0,0;0;0,0;0;0,0
3517208;Guaiçara;2015;0;0,0;0;0,0;0;0,0
3517307;Guaimbê;2015;0;0,0;0;0,0;0;0,0
3517505;Guapiaçu;2015;0;0,0;0;0,0;0;0,0
3517901;Guaraci;2015;0;0,0;0;0,0;0;0,0
3518008;Guarani d'Oeste;2015;0;0,0;0;0,0;0;0,0
3518107;Guarantã;2015;0;0,0;0;0,0;0;0,0
3518503;Guareí;2015;0;0,0;0;0,0;0;0,0
3518859;Guatapará;2015;0;0,0;0;0,0;0;0,0
3518909;Guzolândia;2015;0;0,0;0;0,0;0;0,0
3519055;Holambra;2015;0;0,0;0;0,0;0;0,0
3519253;Iaras;2015;0;0,0;0;0,0;0;0,0
3519501;Ibirarema;2015;0;0,0;0;0,0;0;0,0
3519808;Icém;2015;0;0,0;0;0,0;0;0,0
3520426;Ilha Comprida;2015;0;0,0;0;0,0;0;0,0
3520608;Indiana;2015;0;0,0;0;0,0;0;0,0
3520806;Inúbia Paulista;2015;0;0,0;0;0,0;0;0,0
3521101;Ipeúna;2015;0;0,0;0;0,0;0;0,0
3521150;Ipiguá;2015;0;0,0;0;0,0;0;0,0
3521200;Iporanga;2015;0;0,0;0;0,0;0;0,0
3521408;Iracemápolis;2015;0;0,0;0;0,0;0;0,0
3521507;Irapuã;2015;0;0,0;0;0,0;0;0,0
3521606;Irapuru;2015;0;0,0;0;0,0;0;0,0
3522000;Itaju;2015;0;0,0;0;0,0;0;0,0
3522158;Itaoca;2015;0;0,0;0;0,0;0;0,0
3522653;Itapirapuã Paulista;2015;0;0,0;0;0,0;0;0,0
3523008;Itapura;2015;0;0,0;0;0,0;0;0,0
3523305;Itariri;2015;0;0,0;0;0,0;0;0,0
3523701;Itirapuã;2015;0;0,0;0;0,0;0;0,0
3523800;Itobi;2015;0;0,0;0;0,0;0;0,0
3524600;Jacupiranga;2015;0;0,0;0;0,0;0;0,0
3524907;Jambeiro;2015;0;0,0;0;0,0;0;0,0
3525102;Jardinópolis;2015;0;0,0;0;0,0;0;0,0
3525409;Jeriquara;2015;0;0,0;0;0,0;0;0,0
3525607;João Ramalho;2015;0;0,0;0;0,0;0;0,0
3525805;Júlio Mesquita;2015;0;0,0;0;0,0;0;0,0
3525854;Jumirim;2015;0;0,0;0;0,0;0;0,0
3526308;Lagoinha;2015;0;0,0;0;0,0;0;0,0
3526506;Lavínia;2015;0;0,0;0;0,0;0;0,0
3526605;Lavrinhas;2015;0;0,0;0;0,0;0;0,0
3527009;Lindóia;2015;0;0,0;0;0,0;0;0,0
3527256;Lourdes;2015;0;0,0;0;0,0;0;0,0
3527504;Lucianópolis;2015;0;0,0;0;0,0;0;0,0
3527603;Luís Antônio;2015;0;0,0;0;0,0;0;0,0
3527801;Lupércio;2015;0;0,0;0;0,0;0;0,0
3527900;Lutécia;2015;0;0,0;0;0,0;0;0,0
3528205;Macedônia;2015;0;0,0;0;0,0;0;0,0
3528304;Magda;2015;0;0,0;0;0,0;0;0,0
3528403;Mairinque;2015;0;0,0;0;0,0;0;0,0
3528601;Manduri;2015;0;0,0;0;0,0;0;0,0
3528700;Marabá Paulista;2015;0;0,0;0;0,0;0;0,0
3528858;Marapoama;2015;0;0,0;0;0,0;0;0,0
3528908;Mariápolis;2015;0;0,0;0;0,0;0;0,0
3529104;Marinópolis;2015;0;0,0;0;0,0;0;0,0
3529500;Mendonça;2015;0;0,0;0;0,0;0;0,0
3529609;Meridiano;2015;0;0,0;0;0,0;0;0,0
3529658;Mesópolis;2015;0;0,0;0;0,0;0;0,0
3529807;Mineiros do Tietê;2015;0;0,0;0;0,0;0;0,0
3529906;Miracatu;2015;0;0,0;0;0,0;0;0,0
3530003;Mira Estrela;2015;0;0,0;0;0,0;0;0,0
3530201;Mirante do Paranapanema;2015;0;0,0;0;0,0;0;0,0
3530409;Mirassolândia;2015;0;0,0;0;0,0;0;0,0
3530904;Mombuca;2015;0;0,0;0;0,0;0;0,0
3531001;Monções;2015;0;0,0;0;0,0;0;0,0
3531209;Monte Alegre do Sul;2015;0;0,0;0;0,0;0;0,0
3531605;Monte Castelo;2015;0;0,0;0;0,0;0;0,0
3531704;Monteiro Lobato;2015;0;0,0;0;0,0;0;0,0
3532058;Motuca;2015;0;0,0;0;0,0;0;0,0
3532108;Murutinga do Sul;2015;0;0,0;0;0,0;0;0,0
3532157;Nantes;2015;0;0,0;0;0,0;0;0,0
3532207;Narandiba;2015;0;0,0;0;0,0;0;0,0
3532306;Natividade da Serra;2015;0;0,0;0;0,0;0;0,0
3532702;Nipoã;2015;0;0,0;0;0,0;0;0,0
3532801;Nova Aliança;2015;0;0,0;0;0,0;0;0,0
3532827;Nova Campina;2015;0;0,0;0;0,0;0;0,0
3532843;Nova Canaã Paulista;2015;0;0,0;0;0,0;0;0,0
3532868;Nova Castilho;2015;0;0,0;0;0,0;0;0,0
3533106;Nova Guataporanga;2015;0;0,0;0;0,0;0;0,0
3533205;Nova Independência;2015;0;0,0;0;0,0;0;0,0
3533254;Novais;2015;0;0,0;0;0,0;0;0,0
3533304;Nova Luzitânia;2015;0;0,0;0;0,0;0;0,0
3533601;Nuporanga;2015;0;0,0;0;0,0;0;0,0
3533700;Ocauçu;2015;0;0,0;0;0,0;0;0,0
3533809;Óleo;2015;0;0,0;0;0,0;0;0,0
3534005;Onda Verde;2015;0;0,0;0;0,0;0;0,0
3534104;Oriente;2015;0;0,0;0;0,0;0;0,0
3534203;Orindiúva;2015;0;0,0;0;0,0;0;0,0
3534500;Oscar Bressane;2015;0;0,0;0;0,0;0;0,0
3534807;Ouro Verde;2015;0;0,0;0;0,0;0;0,0
3535002;Palestina;2015;0;0,0;0;0,0;0;0,0
3535101;Palmares Paulista;2015;0;0,0;0;0,0;0;0,0
3535606;Paraibuna;2015;0;0,0;0;0,0;0;0,0
3535705;Paraíso;2015;0;0,0;0;0,0;0;0,0
3535903;Paranapuã;2015;0;0,0;0;0,0;0;0,0
3536109;Pardinho;2015;0;0,0;0;0,0;0;0,0
3536257;Parisi;2015;0;0,0;0;0,0;0;0,0
3536406;Paulicéia;2015;0;0,0;0;0,0;0;0,0
3536570;Paulistânia;2015;0;0,0;0;0,0;0;0,0
3536802;Pedra Bela;2015;0;0,0;0;0,0;0;0,0
3536901;Pedranópolis;2015;0;0,0;0;0,0;0;0,0
3537156;Pedrinhas Paulista;2015;0;0,0;0;0,0;0;0,0
3537206;Pedro de Toledo;2015;0;0,0;0;0,0;0;0,0
3537503;Pereiras;2015;0;0,0;0;0,0;0;0,0
3537602;Peruíbe;2015;0;0,0;0;0,0;0;0,0
3537701;Piacatu;2015;0;0,0;0;0,0;0;0,0
3538105;Pindorama;2015;0;0,0;0;0,0;0;0,0
3538204;Pinhalzinho;2015;0;0,0;0;0,0;0;0,0
3538303;Piquerobi;2015;0;0,0;0;0,0;0;0,0
3538501;Piquete;2015;0;0,0;0;0,0;0;0,0
3539103;Pirapora do Bom Jesus;2015;0;0,0;0;0,0;0;0,0
3539202;Pirapozinho;2015;0;0,0;0;0,0;0;0,0
3539608;Planalto;2015;0;0,0;0;0,0;0;0,0
3539707;Platina;2015;0;0,0;0;0,0;0;0,0
3539905;Poloni;2015;0;0,0;0;0,0;0;0,0
3540101;Pongaí;2015;0;0,0;0;0,0;0;0,0
3540259;Pontalinda;2015;0;0,0;0;0,0;0;0,0
3540309;Pontes Gestal;2015;0;0,0;0;0,0;0;0,0
3540507;Porangaba;2015;0;0,0;0;0,0;0;0,0
3540754;Potim;2015;0;0,0;0;0,0;0;0,0
3540853;Pracinha;2015;0;0,0;0;0,0;0;0,0
3540903;Pradópolis;2015;0;0,0;0;0,0;0;0,0
3541059;Pratânia;2015;0;0,0;0;0,0;0;0,0
3541109;Presidente Alves;2015;0;0,0;0;0,0;0;0,0
3541653;Quadra;2015;0;0,0;0;0,0;0;0,0
3541703;Quatá;2015;0;0,0;0;0,0;0;0,0
3541802;Queiroz;2015;0;0,0;0;0,0;0;0,0
3542008;Quintana;2015;0;0,0;0;0,0;0;0,0
3542107;Rafard;2015;0;0,0;0;0,0;0;0,0
3542305;Redenção da Serra;2015;0;0,0;0;0,0;0;0,0
3542503;Reginópolis;2015;0;0,0;0;0,0;0;0,0
3542701;Restinga;2015;0;0,0;0;0,0;0;0,0
3542800;Ribeira;2015;0;0,0;0;0,0;0;0,0
3543105;Ribeirão Corrente;2015;0;0,0;0;0,0;0;0,0
3543204;Ribeirão do Sul;2015;0;0,0;0;0,0;0;0,0
3543238;Ribeirão dos Índios;2015;0;0,0;0;0,0;0;0,0
3543253;Ribeirão Grande;2015;0;0,0;0;0,0;0;0,0
3543501;Riversul;2015;0;0,0;0;0,0;0;0,0
3543600;Rifaina;2015;0;0,0;0;0,0;0;0,0
3543709;Rincão;2015;0;0,0;0;0,0;0;0,0
3544103;Rio Grande da Serra;2015;0;0,0;0;0,0;0;0,0
3544400;Rubiácea;2015;0;0,0;0;0,0;0;0,0
3544509;Rubinéia;2015;0;0,0;0;0,0;0;0,0
3544608;Sabino;2015;0;0,0;0;0,0;0;0,0
3544707;Sagres;2015;0;0,0;0;0,0;0;0,0
3544806;Sales;2015;0;0,0;0;0,0;0;0,0
3545100;Salmourão;2015;0;0,0;0;0,0;0;0,0
3545159;Saltinho;2015;0;0,0;0;0,0;0;0,0
3545506;Sandovalina;2015;0;0,0;0;0,0;0;0,0
3545704;Santa Albertina;2015;0;0,0;0;0,0;0;0,0
3546009;Santa Branca;2015;0;0,0;0;0,0;0;0,0
3546108;Santa Clara d'Oeste;2015;0;0,0;0;0,0;0;0,0
3546207;Santa Cruz da Conceição;2015;0;0,0;0;0,0;0;0,0
3546256;Santa Cruz da Esperança;2015;0;0,0;0;0,0;0;0,0
3546504;Santa Ernestina;2015;0;0,0;0;0,0;0;0,0
3546702;Santa Gertrudes;2015;0;0,0;0;0,0;0;0,0
3546900;Santa Lúcia;2015;0;0,0;0;0,0;0;0,0
3547106;Santa Mercedes;2015;0;0,0;0;0,0;0;0,0
3547205;Santana da Ponte Pensa;2015;0;0,0;0;0,0;0;0,0
3547403;Santa Rita d'Oeste;2015;0;0,0;0;0,0;0;0,0
3547650;Santa Salete;2015;0;0,0;0;0,0;0;0,0
3548005;Santo Antônio de Posse;2015;0;0,0;0;0,0;0;0,0
3548054;Santo Antônio do Aracanguá;2015;0;0,0;0;0,0;0;0,0
3548104;Santo Antônio do Jardim;2015;0;0,0;0;0,0;0;0,0
3548203;Santo Antônio do Pinhal;2015;0;0,0;0;0,0;0;0,0
3548302;Santo Expedito;2015;0;0,0;0;0,0;0;0,0
3548401;Santópolis do Aguapeí;2015;0;0,0;0;0,0;0;0,0
3549003;São Francisco;2015;0;0,0;0;0,0;0;0,0
3549201;São João das Duas Pontes;2015;0;0,0;0;0,0;0;0,0
3549250;São João de Iracema;2015;0;0,0;0;0,0;0;0,0
3549300;São João do Pau d'Alho;2015;0;0,0;0;0,0;0;0,0
3549508;São José da Bela Vista;2015;0;0,0;0;0,0;0;0,0
3549607;São José do Barreiro;2015;0;0,0;0;0,0;0;0,0
3549953;São Lourenço da Serra;2015;0;0,0;0;0,0;0;0,0
3550506;São Pedro do Turvo;2015;0;0,0;0;0,0;0;0,0
3551108;Sarapuí;2015;0;0,0;0;0,0;0;0,0
3551207;Sarutaiá;2015;0;0,0;0;0,0;0;0,0
3551306;Sebastianópolis do Sul;2015;0;0,0;0;0,0;0;0,0
3551405;Serra Azul;2015;0;0,0;0;0,0;0;0,0
3551801;Sete Barras;2015;0;0,0;0;0,0;0;0,0
3551900;Severínia;2015;0;0,0;0;0,0;0;0,0
3552551;Suzanápolis;2015;0;0,0;0;0,0;0;0,0
3552908;Taciba;2015;0;0,0;0;0,0;0;0,0
3553104;Taiaçu;2015;0;0,0;0;0,0;0;0,0
3553500;Tapiraí;2015;0;0,0;0;0,0;0;0,0
3553658;Taquaral;2015;0;0,0;0;0,0;0;0,0
3553856;Taquarivaí;2015;0;0,0;0;0,0;0;0,0
3553906;Tarabai;2015;0;0,0;0;0,0;0;0,0
3553955;Tarumã;2015;0;0,0;0;0,0;0;0,0
3554201;Tejupá;2015;0;0,0;0;0,0;0;0,0
3554607;Timburi;2015;0;0,0;0;0,0;0;0,0
3554656;Torre de Pedra;2015;0;0,0;0;0,0;0;0,0
3554755;Trabiju;2015;0;0,0;0;0,0;0;0,0
3554805;Tremembé;2015;0;0,0;0;0,0;0;0,0
3554904;Três Fronteiras;2015;0;0,0;0;0,0;0;0,0
3554953;Tuiuti;2015;0;0,0;0;0,0;0;0,0
3555208;Turiúba;2015;0;0,0;0;0,0;0;0,0
3555307;Turmalina;2015;0;0,0;0;0,0;0;0,0
3555356;Ubarana;2015;0;0,0;0;0,0;0;0,0
3555505;Ubirajara;2015;0;0,0;0;0,0;0;0,0
3555604;Uchoa;2015;0;0,0;0;0,0;0;0,0
3555703;União Paulista;2015;0;0,0;0;0,0;0;0,0
3555901;Uru;2015;0;0,0;0;0,0;0;0,0
3556107;Valentim Gentil;2015;0;0,0;0;0,0;0;0,0
3556354;Vargem;2015;0;0,0;0;0,0;0;0,0
3556453;Vargem Grande Paulista;2015;0;0,0;0;0,0;0;0,0
3556602;Vera Cruz;2015;0;0,0;0;0,0;0;0,0
3556909;Vista Alegre do Alto;2015;0;0,0;0;0,0;0;0,0
3556958;Vitória Brasil;2015;0;0,0;0;0,0;0;0,0
3557154;Zacarias;2015;0;0,0;0;0,0;0;0,0
3557303;Estiva Gerbi;2015;0;0,0;0;0,0;0;0,0
3500600;Águas de São Pedro;2015;4;1,4;4;1,4;0;0,0
3501707;Américo Brasiliense;2015;206;5,5;206;5,5;0;0,0
3503109;Arandu;2015;16;2,6;16;2,6;0;0,0
3504909;Bananal;2015;15;1,4;15;1,4;0;0,0
3506359;Bertioga;2015;49;0,9;49;0,9;0;0,0
3506409;Bilac;2015;36;4,8;36;4,8;0;0,0
3507100;Bom Jesus dos Perdões;2015;11;0,5;11;0,5;0;0,0
3508702;Caconde;2015;62;3,3;62;3,3;0;0,0
3509254;Cajati;2015;8;0,3;8;0,3;0;0,0
3509601;Campo Limpo Paulista;2015;56;0,7;56;0,7;0;0,0
3512308;Conchas;2015;32;1,9;32;1,9;0;0,0
3513900;Divinolândia;2015;192;17,4;192;17,4;0;0,0
3514809;Eldorado;2015;2;0,1;2;0,1;0;0,0
3514908;Elias Fausto;2015;6;0,4;6;0,4;0;0,0
3515103;Embu-Guaçu;2015;16;0,2;16;0,2;0;0,0
3515707;Ferraz de Vasconcelos;2015;191;1,1;191;1,1;0;0,0
3517604;Guapiara;2015;19;1,1;19;1,1;0;0,0
3519006;Herculândia;2015;51;5,7;51;5,7;0;0,0
3519303;Ibaté;2015;32;1,0;32;1,0;0;0,0
3519907;Iepê;2015;20;2,6;20;2,6;0;0,0
3520202;Igaratá;2015;15;1,7;15;1,7;0;0,0
3520301;Iguape;2015;13;0,4;13;0,4;0;0,0
3521002;Iperó;2015;15;0,5;15;0,5;0;0,0
3521705;Itaberá;2015;35;2,0;35;2,0;0;0,0
3522109;Itanhaém;2015;77;0,8;77;0,8;0;0,0
3523107;Itaquaquecetuba;2015;224;0,6;224;0,6;0;0,0
3523602;Itirapina;2015;8;0,5;8;0,5;0;0,0
3524204;Jaborandi;2015;17;2,6;17;2,6;0;0,0
3526100;Juquiá;2015;15;0,8;15;0,8;0;0,0
3528502;Mairiporã;2015;47;0,5;47;0,5;0;0,0
3528809;Maracaí;2015;26;1,9;26;1,9;0;0,0
3530102;Mirandópolis;2015;90;3,2;90;3,2;0;0,0
3531100;Mongaguá;2015;44;0,9;44;0,9;0;0,0
3532405;Nazaré Paulista;2015;24;1,4;24;1,4;0;0,0
3533403;Nova Odessa;2015;53;1,0;53;1,0;0;0,0
3535804;Paranapanema;2015;30;1,6;30;1,6;0;0,0
3536208;Pariquera-Açu;2015;151;8,0;151;8,0;0;0,0
3536505;Paulínia;2015;85;0,9;85;0,9;0;0,0
3537107;Pedreira;2015;98;2,2;98;2,2;0;0,0
3539806;Poá;2015;33;0,3;33;0,3;0;0,0
3541604;Promissão;2015;58;1,5;58;1,5;0;0,0
3541901;Queluz;2015;19;1,6;19;1,6;0;0,0
3544251;Rosana;2015;57;3,0;57;3,0;0;0,0
3544301;Roseira;2015;14;1,4;14;1,4;0;0,0
3547007;Santa Maria da Serra;2015;6;1,0;6;1,0;0;0,0
3547304;Santana de Parnaíba;2015;35;0,3;35;0,3;0;0,0
3547908;Santo Antônio da Alegria;2015;12;1,9;12;1,9;0;0,0
3550209;São Miguel Arcanjo;2015;50;1,6;50;1,6;0;0,0
3552007;Silveiras;2015;3;0,5;3;0,5;0;0,0
3552304;Sud Mennucci;2015;20;2,6;20;2,6;0;0,0
3553203;Taiúva;2015;4;0,6;4;0,6;0;0,0
3507407;Borborema;2015;26;1,7;16;1,1;10;0,7
3511904;Clementina;2015;30;3,9;20;2,6;10;1,3
3512100;Colômbia;2015;30;5,0;20;3,3;10;1,7
3514502;Duartina;2015;87;7,2;77;6,4;10;0,8
3521309;Ipuã;2015;49;3,3;39;2,6;10;0,7
3527405;Lucélia;2015;25;1,2;15;0,7;10;0,5
3532009;Morungaba;2015;23;1,8;13;1,0;10;0,8
3538907;Pirajuí;2015;299;12,9;289;12,5;10;0,4
3540408;Populina;2015;18;4,4;8;2,0;10;2,4
3541307;Presidente Epitácio;2015;78;1,9;68;1,6;10;0,2
3544905;Sales Oliveira;2015;29;2,6;19;1,7;10;0,9
3505807;Bastos;2015;35;1,7;28;1,4;7;0,3
3508603;Cachoeira Paulista;2015;47;1,5;40;1,3;7;0,2
3511706;Charqueada;2015;33;2,1;26;1,6;7;0,4
3517802;Guaraçaí;2015;27;3,2;20;2,4;7;0,8
3518602;Guariba;2015;72;1,9;65;1,7;7;0,2
3522901;Itapuí;2015;40;3,1;33;2,5;7;0,5
3523503;Itatinga;2015;14;0,7;7;0,4;7;0,4
3525508;Joanópolis;2015;24;2,0;17;1,4;7;0,6
3527306;Louveira;2015;41;0,9;34;0,8;7;0,2
3531803;Monte Mor;2015;36;0,7;29;0,5;7;0,1
3542404;Regente Feijó;2015;24;1,3;17;0,9;7;0,4
3550100;São Manuel;2015;43;1,1;36;0,9;7;0,2
3554706;Torrinha;2015;20;2,1;13;1,4;7;0,7
3501004;Altinópolis;2015;31;2,0;25;1,6;6;0,4
3502705;Apiaí;2015;51;2,1;45;1,8;6;0,2
3507902;Brotas;2015;41;1,8;35;1,5;6;0,3
3509304;Cajobi;2015;32;3,2;26;2,6;6;0,6
3518305;Guararema;2015;35;1,3;29;1,0;6;0,2
3536000;Parapuã;2015;32;3,0;26;2,4;6;0,6
3540002;Pompéia;2015;42;2,0;36;1,7;6;0,3
3542909;Ribeirão Bonito;2015;17;1,4;11;0,9;6;0,5
3554300;Teodoro Sampaio;2015;58;2,6;52;2,4;6;0,3
3515400;Fartura;2015;20;1,3;12;0,8;8;0,5
3517703;Guará;2015;30;1,5;22;1,1;8;0,4
3520004;Igaraçu do Tietê;2015;63;2,7;55;2,3;8;0,3
3529203;Martinópolis;2015;51;2,0;43;1,7;8;0,3
3537909;Pilar do Sul;2015;35;1,3;27;1,0;8;0,3
3538600;Piracaia;2015;37;1,4;29;1,1;8;0,3
3543808;Rinópolis;2015;33;3,4;25;2,5;8;0,8
3550704;São Sebastião;2015;101;1,2;93;1,2;8;0,1
3552106;Socorro;2015;62;1,6;54;1,4;8;0,2
3556503;Várzea Paulista;2015;35;0,3;27;0,2;8;0,1
3510005;Cândido Mota;2015;30;1,0;25;0,8;5;0,2
3515004;Embu das Artes;2015;81;0,3;76;0,3;5;0,0
3532900;Nova Europa;2015;12;1,2;7;0,7;5;0,5
3534906;Pacaembu;2015;37;2,8;32;2,4;5;0,4
3553005;Taguaí;2015;29;2,4;24;2,0;5;0,4
3553609;Tapiratiba;2015;24;1,9;19;1,5;5;0,4
3555406;Ubatuba;2015;79;0,9;74;0,9;5;0,1
3501301;Álvares Machado;2015;20;0,8;18;0,8;2;0,1
3506706;Boa Esperança do Sul;2015;15;1,1;13;0,9;2;0,1
3513108;Cravinhos;2015;15;0,5;13;0,4;2;0,1
3519105;Iacanga;2015;27;2,5;25;2,3;2;0,2
3524709;Jaguariúna;2015;80;1,6;78;1,5;2;0,0
3545001;Salesópolis;2015;19;1,2;17;1,0;2;0,1
3555802;Urânia;2015;26;3,0;24;2,7;2;0,2
3507001;Boituva;2015;55;1,0;36;0,7;19;0,4
3522802;Itaporanga;2015;46;3,2;27;1,8;19;1,3
3529708;Miguelópolis;2015;66;3,1;47;2,2;19;0,9
3531506;Monte Azul Paulista;2015;70;3,8;51;2,7;19;1,0
3535507;Paraguaçu Paulista;2015;97;2,2;78;1,8;19;0,4
3546801;Santa Isabel;2015;101;1,9;82;1,6;19;0,4
3547700;Santo Anastácio;2015;56;2,8;37;1,8;19;0,9
3509403;Cajuru;2015;73;3,0;55;2,2;18;0,7
3510203;Capão Bonito;2015;67;1,5;49;1,1;18;0,4
3511409;Cerqueira César;2015;52;2,8;34;1,8;18;1,0
3517406;Guaíra;2015;60;1,6;42;1,1;18;0,5
3538808;Piraju;2015;73;2,6;55;1,9;18;0,6
3539509;Pitangueiras;2015;50;1,4;32;0,9;18;0,5
3503802;Artur Nogueira;2015;12;0,2;0;0,0;12;0,2
3511508;Cerquilho;2015;43;1,0;31;0,7;12;0,3
3512001;Colina;2015;47;2,7;35;2,0;12;0,7
3517000;Getulina;2015;48;4,4;36;3,3;12;1,1
3536307;Patrocínio Paulista;2015;35;2,5;23;1,7;12;0,9
3540606;Porto Feliz;2015;51;1,0;39;0,8;12;0,2
3545407;Salto Grande;2015;34;3,8;22;2,5;12;1,3
3547601;Santa Rosa de Viterbo;2015;30;1,2;18;0,7;12;0,5
3550902;São Simão;2015;50;3,4;38;2,6;12;0,8
3556701;Vinhedo;2015;32;0,5;20;0,3;12;0,2
3508405;Cabreúva;2015;13;0,3;9;0,2;4;0,1
3513504;Cubatão;2015;138;1,1;134;1,1;4;0,0
3519204;Iacri;2015;19;3,0;15;2,4;4;0,6
3519709;Ibiúna;2015;67;0,9;63;0,9;4;0,1
3539400;Piratininga;2015;30;2,4;26;2,1;4;0,3
3550803;São Sebastião da Grama;2015;30;2,5;26;2,2;4;0,3
3501103;Alto Alegre;2015;22;5,4;19;4,7;3;0,7
3502200;Angatuba;2015;57;2,4;54;2,3;3;0,1
3514304;Dourado;2015;19;2,2;16;1,9;3;0,4
3520400;Ilhabela;2015;49;1,6;46;1,5;3;0,1
3521804;Itaí;2015;39;1,5;36;1,4;3;0,1
3540804;Potirendaba;2015;31;1,9;28;1,7;3;0,2
3503406;Arealva;2015;28;3,5;17;2,1;11;1,4
3508801;Cafelândia;2015;58;3,4;47;2,8;11;0,6
3512209;Conchal;2015;52;2,0;41;1,6;11;0,4
3528106;Macaubal;2015;24;3,1;13;1,7;11;1,4
3541208;Presidente Bernardes;2015;51;3,7;40;2,9;11;0,8
3553302;Tambaú;2015;36;1,6;25;1,1;11;0,5
3511607;Cesário Lange;2015;30;1,8;17;1,0;13;0,8
3528007;Macatuba;2015;31;1,9;18;1,1;13;0,8
3552700;Tabatinga;2015;35;2,3;22;1,4;13;0,8
3503703;Ariranha;2015;25;2,8;4;0,4;21;2,3
3516606;Gália;2015;45;6,7;24;3,6;21;3,1
3525201;Jarinu;2015;33;1,2;12;0,4;21;0,8
3546306;Santa Cruz das Palmeiras;2015;46;1,4;25;0,8;21;0,7
3552601;Tabapuã;2015;30;2,6;9;0,8;21;1,8
3553807;Taquarituba;2015;53;2,3;32;1,4;21;0,9
3556008;Urupês;2015;34;2,6;13;1,0;21;1,6
3526209;Juquitiba;2015;9;0,3;0;0,0;9;0,3
3508108;Buritama;2015;42;2,6;22;1,4;20;1,2
3514106;Dois Córregos;2015;67;2,6;47;1,8;20;0,8
3520905;Ipaussu;2015;49;3,5;29;2,1;20;1,4
3536703;Pederneiras;2015;72;1,7;52;1,2;20;0,5
3537008;Pedregulho;2015;53;3,3;33;2,1;20;1,2
3513603;Cunha;2015;40;1,8;25;1,2;15;0,7
3513702;Descalvado;2015;40;1,3;25;0,8;15;0,5
3523206;Itararé;2015;93;1,9;78;1,6;15;0,3
3526407;Laranjal Paulista;2015;47;1,8;32;1,2;15;0,6
3536604;Paulo de Faria;2015;24;2,8;9;1,1;15;1,8
3544004;Rio das Pedras;2015;53;1,6;38;1,2;15;0,5
3550001;São Luiz do Paraitinga;2015;26;2,5;11;1,1;15;1,4
3551504;Serrana;2015;58;1,4;43;1,0;15;0,4
3500105;Adamantina;2015;279;8,2;240;7,1;39;1,2
3500709;Agudos;2015;60;1,7;38;1,1;22;0,6
3501608;Americana;2015;698;3,1;343;1,5;355;1,6
3501905;Amparo;2015;357;5,3;242;3,6;115;1,7
3502101;Andradina;2015;136;2,4;110;2,0;26;0,5
3502507;Aparecida;2015;104;2,9;70;2,0;34;1,0
3502606;Aparecida d'Oeste;2015;21;4,9;20;4,7;1;0,2
3502804;Araçatuba;2015;635;3,4;478;2,6;157;0,8
3502903;Araçoiaba da Serra;2015;288;9,6;0;0,0;288;9,6
3503208;Araraquara;2015;510;2,3;199;0,9;311;1,4
3503307;Araras;2015;567;4,5;307;2,5;260;2,1
3503901;Arujá;2015;82;1,0;15;0,2;67;0,8
3504008;Assis;2015;290;2,9;179;1,8;111;1,1
3504107;Atibaia;2015;192;1,4;55;0,4;137;1,0
3504503;Avaré;2015;153;1,8;95;1,1;58;0,7
3505203;Bariri;2015;68;2,1;52;1,6;16;0,5
3505302;Barra Bonita;2015;101;2,9;68;1,9;33;0,9
3505500;Barretos;2015;604;5,2;501;4,3;103;0,9
3505708;Barueri;2015;519;2,1;371;1,5;148;0,6
3505906;Batatais;2015;139;2,4;94;1,6;45;0,8
3506003;Bauru;2015;1.008;2,8;638;1,8;370;1,0
3506102;Bebedouro;2015;129;1,7;81;1,1;48;0,6
3506300;Bernardino de Campos;2015;50;4,6;20;1,9;30;2,8
3506508;Birigui;2015;146;1,3;66;0,6;80;0,7
3507506;Botucatu;2015;742;5,5;542;4,0;200;1,5
3507605;Bragança Paulista;2015;334;2,1;208;1,3;126;0,8
3508504;Caçapava;2015;151;1,7;73;0,8;78;0,9
3509007;Caieiras;2015;117;1,2;58;0,6;59;0,6
3509205;Cajamar;2015;171;2,4;71;1,0;100;1,4
3509502;Campinas;2015;2.957;2,6;1.395;1,2;1.562;1,4
3509700;Campos do Jordão;2015;242;4,9;195;4,0;47;1,0
3510401;Capivari;2015;96;1,9;46;0,9;50;1,0
3510500;Caraguatatuba;2015;157;1,4;102;0,9;55;0,5
3510609;Carapicuíba;2015;370;1,0;280;0,7;90;0,2
3510708;Cardoso;2015;31;2,6;14;1,2;17;1,4
3510807;Casa Branca;2015;372;12,9;355;12,3;17;0,6
3511102;Catanduva;2015;534;4,6;375;3,3;159;1,4
3511300;Cedral;2015;30;3,6;0;0,0;30;3,6
3512803;Cosmópolis;2015;90;1,4;63;1,0;27;0,4
3513009;Cotia;2015;289;1,3;111;0,5;178;0,8
3513405;Cruzeiro;2015;120;1,5;77;1,0;43;0,5
3513801;Diadema;2015;635;1,6;566;1,4;69;0,2
3514403;Dracena;2015;143;3,2;108;2,4;35;0,8
3515186;Espírito Santo do Pinhal;2015;458;10,8;369;8,7;89;2,1
3515509;Fernandópolis;2015;180;2,7;84;1,3;96;1,5
3516200;Franca;2015;739;2,2;487;1,5;252;0,8
3516309;Francisco Morato;2015;144;0,9;95;0,6;49;0,3
3516408;Franco da Rocha;2015;396;2,8;314;2,2;82;0,6
3516705;Garça;2015;377;8,8;332;7,8;45;1,1
3516903;General Salgado;2015;32;3,0;8;0,7;24;2,2
3518404;Guaratinguetá;2015;278;2,4;162;1,4;116;1,0
3518701;Guarujá;2015;321;1,1;234;0,8;87;0,3
3518800;Guarulhos;2015;1.847;1,4;1.429;1,1;418;0,3
3519071;Hortolândia;2015;91;0,4;62;0,3;29;0,1
3519402;Ibirá;2015;25;2,2;8;0,7;17;1,5
3519600;Ibitinga;2015;99;1,8;46;0,8;53;0,9
3520103;Igarapava;2015;60;2,1;32;1,1;28;1,0
3520442;Ilha Solteira;2015;116;4,6;74;2,9;42;1,6
3520509;Indaiatuba;2015;378;1,7;268;1,2;110;0,5
3520707;Indiaporã;2015;46;11,9;4;1,0;42;10,9
3521903;Itajobi;2015;30;2,1;13;0,9;17;1,2
3522208;Itapecerica da Serra;2015;501;3,1;196;1,2;305;1,9
3522307;Itapetininga;2015;122;0,8;100;0,7;22;0,1
3522406;Itapeva;2015;164;1,8;122;1,4;42;0,5
3522505;Itapevi;2015;265;1,2;205;0,9;60;0,3
3522604;Itapira;2015;1.284;18,3;749;10,6;535;7,6
3522703;Itápolis;2015;76;1,9;45;1,1;31;0,8
3523404;Itatiba;2015;119;1,1;60;0,5;59;0,5
3523909;Itu;2015;426;2,6;391;2,4;35;0,2
3524006;Itupeva;2015;86;1,6;48;0,9;38;0,7
3524105;Ituverava;2015;121;3,1;55;1,4;66;1,7
3524303;Jaboticabal;2015;172;2,4;56;0,8;116;1,6
3524402;Jacareí;2015;440;2,0;211;1,0;229;1,0
3524501;Jaci;2015;191;30,1;150;23,6;41;6,5
3524808;Jales;2015;165;3,5;112;2,4;53;1,1
3525003;Jandira;2015;40;0,3;26;0,2;14;0,1
3525300;Jaú;2015;860;6,1;705;5,0;155;1,1
3525706;José Bonifácio;2015;61;1,8;29;0,8;32;0,9
3525904;Jundiaí;2015;800;2,0;376;1,0;424;1,1
3526001;Junqueirópolis;2015;52;2,7;26;1,3;26;1,3
3526704;Leme;2015;124;1,3;76;0,8;48;0,5
3526803;Lençóis Paulista;2015;81;1,3;54;0,8;27;0,4
3526902;Limeira;2015;404;1,4;200;0,7;204;0,7
3527108;Lins;2015;444;6,0;349;4,7;95;1,3
3527207;Lorena;2015;170;2,0;82;1,0;88;1,0
3527702;Luiziânia;2015;32;5,9;15;2,8;17;3,2
3529005;Marília;2015;854;3,8;709;3,2;145;0,6
3529302;Matão;2015;162;2,1;96;1,2;66;0,8
3529401;Mauá;2015;415;0,9;272;0,6;143;0,3
3530300;Mirassol;2015;81;1,4;29;0,5;52;0,9
3530508;Mococa;2015;135;2,0;86;1,3;49;0,7
3530607;Mogi das Cruzes;2015;828;2,0;650;1,6;178;0,4
3530706;Mogi Guaçu;2015;333;2,3;154;1,1;179;1,3
3530805;Mogi Mirim;2015;241;2,7;133;1,5;108;1,2
3531308;Monte Alto;2015;109;2,3;58;1,2;51;1,1
3531407;Monte Aprazível;2015;80;3,5;31;1,4;49;2,2
3531902;Morro Agudo;2015;45;1,5;31;1,0;14;0,5
3532504;Neves Paulista;2015;35;4,0;11;1,3;24;2,8
3532603;Nhandeara;2015;129;11,9;35;3,2;94;8,7
3533007;Nova Granada;2015;193;9,6;19;0,9;174;8,7
3533502;Novo Horizonte;2015;105;2,8;35;0,9;70;1,8
3533908;Olímpia;2015;99;1,9;63;1,2;36;0,7
3534302;Orlândia;2015;98;2,4;59;1,4;39;0,9
3534401;Osasco;2015;1.008;1,5;605;0,9;403;0,6
3534609;Osvaldo Cruz;2015;90;2,9;59;1,9;31;1,0
3534708;Ourinhos;2015;328;3,1;143;1,3;185;1,7
3534757;Ouroeste;2015;39;4,3;10;1,1;29;3,2
3535200;Palmeira d'Oeste;2015;24;2,6;10;1,1;14;1,5
3535309;Palmital;2015;68;3,2;44;2,1;24;1,1
3535408;Panorama;2015;36;2,4;35;2,3;1;0,1
3537305;Penápolis;2015;238;4,0;168;2,8;70;1,2
3537404;Pereira Barreto;2015;104;4,1;71;2,8;33;1,3
3537800;Piedade;2015;521;9,9;471;8,9;50;0,9
3538006;Pindamonhangaba;2015;201;1,3;127;0,8;74;0,5
3538709;Piracicaba;2015;761;2,0;309;0,8;452;1,2
3539004;Pirangi;2015;41;3,8;9;0,8;32;3,0
3539301;Pirassununga;2015;94;1,3;57;0,8;37;0,5
3540200;Pontal;2015;45;1,0;29;0,6;16;0,4
3540705;Porto Ferreira;2015;61;1,2;33;0,6;28;0,5
3541000;Praia Grande;2015;194;0,7;118;0,4;76;0,3
3541406;Presidente Prudente;2015;1.559;7,3;1.088;5,1;471;2,2
3541505;Presidente Venceslau;2015;97;2,6;75;2,0;22;0,6
3542206;Rancharia;2015;98;3,4;70;2,4;28;1,0
3542602;Registro;2015;110;2,0;68;1,3;42;0,8
3543006;Ribeirão Branco;2015;36;2,0;35;2,0;1;0,1
3543303;Ribeirão Pires;2015;164;1,4;50;0,4;114;1,0
3543402;Ribeirão Preto;2015;2.044;3,2;1.399;2,2;645;1,0
3543907;Rio Claro;2015;482;2,5;278;1,4;204;1,1
3544202;Riolândia;2015;36;3,3;7;0,6;29;2,6
3545209;Salto;2015;123;1,1;70;0,6;53;0,5
3545308;Salto de Pirapora;2015;1.026;24,3;1.000;23,7;26;0,6
3545605;Santa Adélia;2015;23;1,6;7;0,5;16;1,1
3545803;Santa Bárbara d'Oeste;2015;149;0,8;84;0,5;65;0,4
3546405;Santa Cruz do Rio Pardo;2015;100;2,2;65;1,4;35;0,8
3546603;Santa Fé do Sul;2015;76;2,5;33;1,1;43;1,4
3547502;Santa Rita do Passa Quatro;2015;299;11,3;276;10,4;23;0,9
3547809;Santo André;2015;1.245;1,8;706;1,0;539;0,8
3548500;Santos;2015;1.636;3,9;799;1,9;837;2,0
3548609;São Bento do Sapucaí;2015;40;3,8;26;2,5;14;1,3
3548708;São Bernardo do Campo;2015;1.528;1,9;569;0,7;959;1,2
3548807;São Caetano do Sul;2015;424;2,8;182;1,2;242;1,6
3548906;São Carlos;2015;419;1,8;204;0,9;215;0,9
3549102;São João da Boa Vista;2015;199;2,3;94;1,1;105;1,2
3549409;São Joaquim da Barra;2015;115;2,4;68;1,4;47;1,0
3549706;São José do Rio Pardo;2015;145;2,8;89;1,7;56;1,1
3549805;São José do Rio Preto;2015;1.861;4,3;997;2,3;864;2,0
3549904;São José dos Campos;2015;1.421;2,1;740;1,1;681;1,0
3550308;São Paulo;2015;29.392;2,5;15.698;1,4;13.694;1,2
3550407;São Pedro;2015;62;1,9;37;1,1;25;0,8
3550605;São Roque;2015;89;1,1;41;0,5;48;0,6
3551009;São Vicente;2015;287;0,8;170;0,5;117;0,3
3551603;Serra Negra;2015;49;1,8;33;1,2;16;0,6
3551702;Sertãozinho;2015;157;1,3;64;0,5;93;0,8
3552205;Sorocaba;2015;1.924;3,1;1.165;1,9;759;1,2
3552403;Sumaré;2015;189;0,7;172;0,7;17;0,1
3552502;Suzano;2015;173;0,6;84;0,3;89;0,3
3552809;Taboão da Serra;2015;505;1,9;334;1,3;171;0,6
3553401;Tanabi;2015;72;2,9;32;1,3;40;1,6
3553708;Taquaritinga;2015;124;2,3;73;1,3;51;0,9
3554003;Tatuí;2015;198;1,7;85;0,7;113;1,0
3554102;Taubaté;2015;497;1,7;325;1,1;172;0,6
3554508;Tietê;2015;69;1,8;42;1,1;27;0,7
3555000;Tupã;2015;864;13,7;781;12,4;83;1,3
3556206;Valinhos;2015;169;1,4;63;0,5;106;0,9
3556305;Valparaíso;2015;55;2,4;31;1,3;24;1,0
3556404;Vargem Grande do Sul;2015;77;1,9;47;1,2;30;0,7
3557006;Votorantim;2015;150;1,3;88;0,8;62;0,5
3557105;Votuporanga;2015;208;2,4;125;1,4;83;0,9
3500501;Águas de Lindóia;2015;42;2,4;30;1,7;12;0,7
3504206;Auriflama;2015;51;3,6;30;2,1;21;1,5
3506805;Bocaina;2015;35;3,0;30;2,6;5;0,4
3511003;Castilho;2015;31;1,6;30;1,5;1;0,1
3515202;Estrela d'Oeste;2015;50;6,1;30;3,7;20;2,5
3516002;Flórida Paulista;2015;47;3,8;30;2,4;17;1,4
3518206;Guararapes;2015;74;2,4;30;1,0;44;1,4
3554409;Terra Roxa;2015;34;3,9;30;3,4;4;0,5
3555109;Tupi Paulista;2015;48;3,3;30;2,0;18;1,2
3556800;Viradouro;2015;48;2,7;30;1,7;18;1,0
3557204;Chavantes;2015;50;4,1;30;2,5;20;1,6
3500204;Adolfo;2014;0;0,0;0;0,0;0;0,0
3500303;Aguaí;2014;0;0,0;0;0,0;0;0,0
3500402;Águas da Prata;2014;0;0,0;0;0,0;0;0,0
3500550;Águas de Santa Bárbara;2014;0;0,0;0;0,0;0;0,0
3500758;Alambari;2014;0;0,0;0;0,0;0;0,0
3500808;Alfredo Marcondes;2014;0;0,0;0;0,0;0;0,0
3500907;Altair;2014;0;0,0;0;0,0;0;0,0
3501152;Alumínio;2014;0;0,0;0;0,0;0;0,0
3501202;Álvares Florence;2014;0;0,0;0;0,0;0;0,0
3501400;Álvaro de Carvalho;2014;0;0,0;0;0,0;0;0,0
3501509;Alvinlândia;2014;0;0,0;0;0,0;0;0,0
3501806;Américo de Campos;2014;0;0,0;0;0,0;0;0,0
3502002;Analândia;2014;0;0,0;0;0,0;0;0,0
3502309;Anhembi;2014;0;0,0;0;0,0;0;0,0
3502408;Anhumas;2014;0;0,0;0;0,0;0;0,0
3503000;Aramina;2014;0;0,0;0;0,0;0;0,0
3503158;Arapeí;2014;0;0,0;0;0,0;0;0,0
3503356;Arco-Íris;2014;0;0,0;0;0,0;0;0,0
3503505;Areias;2014;0;0,0;0;0,0;0;0,0
3503604;Areiópolis;2014;0;0,0;0;0,0;0;0,0
3503950;Aspásia;2014;0;0,0;0;0,0;0;0,0
3504305;Avaí;2014;0;0,0;0;0,0;0;0,0
3504404;Avanhandava;2014;0;0,0;0;0,0;0;0,0
3504602;Bady Bassitt;2014;0;0,0;0;0,0;0;0,0
3504701;Balbinos;2014;0;0,0;0;0,0;0;0,0
3504800;Bálsamo;2014;0;0,0;0;0,0;0;0,0
3505005;Barão de Antonina;2014;0;0,0;0;0,0;0;0,0
3505104;Barbosa;2014;0;0,0;0;0,0;0;0,0
3505351;Barra do Chapéu;2014;0;0,0;0;0,0;0;0,0
3505401;Barra do Turvo;2014;0;0,0;0;0,0;0;0,0
3505609;Barrinha;2014;0;0,0;0;0,0;0;0,0
3506201;Bento de Abreu;2014;0;0,0;0;0,0;0;0,0
3506607;Biritiba Mirim;2014;0;0,0;0;0,0;0;0,0
3506904;Bofete;2014;0;0,0;0;0,0;0;0,0
3507159;Bom Sucesso de Itararé;2014;0;0,0;0;0,0;0;0,0
3507209;Borá;2014;0;0,0;0;0,0;0;0,0
3507308;Boracéia;2014;0;0,0;0;0,0;0;0,0
3507456;Borebi;2014;0;0,0;0;0,0;0;0,0
3507704;Braúna;2014;0;0,0;0;0,0;0;0,0
3507753;Brejo Alegre;2014;0;0,0;0;0,0;0;0,0
3507803;Brodowski;2014;0;0,0;0;0,0;0;0,0
3508009;Buri;2014;0;0,0;0;0,0;0;0,0
3508207;Buritizal;2014;0;0,0;0;0,0;0;0,0
3508306;Cabrália Paulista;2014;0;0,0;0;0,0;0;0,0
3508900;Caiabu;2014;0;0,0;0;0,0;0;0,0
3509106;Caiuá;2014;0;0,0;0;0,0;0;0,0
3509452;Campina do Monte Alegre;2014;0;0,0;0;0,0;0;0,0
3509809;Campos Novos Paulista;2014;0;0,0;0;0,0;0;0,0
3509908;Cananéia;2014;0;0,0;0;0,0;0;0,0
3509957;Canas;2014;0;0,0;0;0,0;0;0,0
3510104;Cândido Rodrigues;2014;0;0,0;0;0,0;0;0,0
3510153;Canitar;2014;0;0,0;0;0,0;0;0,0
3510302;Capela do Alto;2014;0;0,0;0;0,0;0;0,0
3510906;Cássia dos Coqueiros;2014;0;0,0;0;0,0;0;0,0
3511201;Catiguá;2014;0;0,0;0;0,0;0;0,0
3511300;Cedral;2014;0;0,0;0;0,0;0;0,0
3512407;Cordeirópolis;2014;0;0,0;0;0,0;0;0,0
3512506;Coroados;2014;0;0,0;0;0,0;0;0,0
3512605;Coronel Macedo;2014;0;0,0;0;0,0;0;0,0
3512704;Corumbataí;2014;0;0,0;0;0,0;0;0,0
3512902;Cosmorama;2014;0;0,0;0;0,0;0;0,0
3513207;Cristais Paulista;2014;0;0,0;0;0,0;0;0,0
3513306;Cruzália;2014;0;0,0;0;0,0;0;0,0
3513850;Dirce Reis;2014;0;0,0;0;0,0;0;0,0
3514007;Dobrada;2014;0;0,0;0;0,0;0;0,0
3514205;Dolcinópolis;2014;0;0,0;0;0,0;0;0,0
3514601;Dumont;2014;0;0,0;0;0,0;0;0,0
3514700;Echaporã;2014;0;0,0;0;0,0;0;0,0
3514924;Elisiário;2014;0;0,0;0;0,0;0;0,0
3514957;Embaúba;2014;0;0,0;0;0,0;0;0,0
3515129;Emilianópolis;2014;0;0,0;0;0,0;0;0,0
3515152;Engenheiro Coelho;2014;0;0,0;0;0,0;0;0,0
3515194;Espírito Santo do Turvo;2014;0;0,0;0;0,0;0;0,0
3515301;Estrela do Norte;2014;0;0,0;0;0,0;0;0,0
3515350;Euclides da Cunha Paulista;2014;0;0,0;0;0,0;0;0,0
3515608;Fernando Prestes;2014;0;0,0;0;0,0;0;0,0
3515657;Fernão;2014;0;0,0;0;0,0;0;0,0
3515806;Flora Rica;2014;0;0,0;0;0,0;0;0,0
3515905;Floreal;2014;0;0,0;0;0,0;0;0,0
3516101;Florínea;2014;0;0,0;0;0,0;0;0,0
3516507;Gabriel Monteiro;2014;0;0,0;0;0,0;0;0,0
3516804;Gastão Vidigal;2014;0;0,0;0;0,0;0;0,0
3516853;Gavião Peixoto;2014;0;0,0;0;0,0;0;0,0
3517109;Glicério;2014;0;0,0;0;0,0;0;0,0
3517208;Guaiçara;2014;0;0,0;0;0,0;0;0,0
3517307;Guaimbê;2014;0;0,0;0;0,0;0;0,0
3517505;Guapiaçu;2014;0;0,0;0;0,0;0;0,0
3517901;Guaraci;2014;0;0,0;0;0,0;0;0,0
3518008;Guarani d'Oeste;2014;0;0,0;0;0,0;0;0,0
3518107;Guarantã;2014;0;0,0;0;0,0;0;0,0
3518503;Guareí;2014;0;0,0;0;0,0;0;0,0
3518859;Guatapará;2014;0;0,0;0;0,0;0;0,0
3518909;Guzolândia;2014;0;0,0;0;0,0;0;0,0
3519055;Holambra;2014;0;0,0;0;0,0;0;0,0
3519253;Iaras;2014;0;0,0;0;0,0;0;0,0
3519501;Ibirarema;2014;0;0,0;0;0,0;0;0,0
3519808;Icém;2014;0;0,0;0;0,0;0;0,0
3520426;Ilha Comprida;2014;0;0,0;0;0,0;0;0,0
3520608;Indiana;2014;0;0,0;0;0,0;0;0,0
3520806;Inúbia Paulista;2014;0;0,0;0;0,0;0;0,0
3521101;Ipeúna;2014;0;0,0;0;0,0;0;0,0
3521150;Ipiguá;2014;0;0,0;0;0,0;0;0,0
3521200;Iporanga;2014;0;0,0;0;0,0;0;0,0
3521408;Iracemápolis;2014;0;0,0;0;0,0;0;0,0
3521507;Irapuã;2014;0;0,0;0;0,0;0;0,0
3521606;Irapuru;2014;0;0,0;0;0,0;0;0,0
3522000;Itaju;2014;0;0,0;0;0,0;0;0,0
3522158;Itaoca;2014;0;0,0;0;0,0;0;0,0
3522653;Itapirapuã Paulista;2014;0;0,0;0;0,0;0;0,0
3523008;Itapura;2014;0;0,0;0;0,0;0;0,0
3523305;Itariri;2014;0;0,0;0;0,0;0;0,0
3523701;Itirapuã;2014;0;0,0;0;0,0;0;0,0
3523800;Itobi;2014;0;0,0;0;0,0;0;0,0
3524600;Jacupiranga;2014;0;0,0;0;0,0;0;0,0
3524907;Jambeiro;2014;0;0,0;0;0,0;0;0,0
3525102;Jardinópolis;2014;0;0,0;0;0,0;0;0,0
3525409;Jeriquara;2014;0;0,0;0;0,0;0;0,0
3525607;João Ramalho;2014;0;0,0;0;0,0;0;0,0
3525805;Júlio Mesquita;2014;0;0,0;0;0,0;0;0,0
3525854;Jumirim;2014;0;0,0;0;0,0;0;0,0
3526308;Lagoinha;2014;0;0,0;0;0,0;0;0,0
3526506;Lavínia;2014;0;0,0;0;0,0;0;0,0
3526605;Lavrinhas;2014;0;0,0;0;0,0;0;0,0
3527009;Lindóia;2014;0;0,0;0;0,0;0;0,0
3527256;Lourdes;2014;0;0,0;0;0,0;0;0,0
3527504;Lucianópolis;2014;0;0,0;0;0,0;0;0,0
3527603;Luís Antônio;2014;0;0,0;0;0,0;0;0,0
3527801;Lupércio;2014;0;0,0;0;0,0;0;0,0
3527900;Lutécia;2014;0;0,0;0;0,0;0;0,0
3528205;Macedônia;2014;0;0,0;0;0,0;0;0,0
3528304;Magda;2014;0;0,0;0;0,0;0;0,0
3528403;Mairinque;2014;0;0,0;0;0,0;0;0,0
3528601;Manduri;2014;0;0,0;0;0,0;0;0,0
3528700;Marabá Paulista;2014;0;0,0;0;0,0;0;0,0
3528858;Marapoama;2014;0;0,0;0;0,0;0;0,0
3528908;Mariápolis;2014;0;0,0;0;0,0;0;0,0
3529104;Marinópolis;2014;0;0,0;0;0,0;0;0,0
3529500;Mendonça;2014;0;0,0;0;0,0;0;0,0
3529609;Meridiano;2014;0;0,0;0;0,0;0;0,0
3529658;Mesópolis;2014;0;0,0;0;0,0;0;0,0
3529807;Mineiros do Tietê;2014;0;0,0;0;0,0;0;0,0
3529906;Miracatu;2014;0;0,0;0;0,0;0;0,0
3530003;Mira Estrela;2014;0;0,0;0;0,0;0;0,0
3530201;Mirante do Paranapanema;2014;0;0,0;0;0,0;0;0,0
3530409;Mirassolândia;2014;0;0,0;0;0,0;0;0,0
3530904;Mombuca;2014;0;0,0;0;0,0;0;0,0
3531001;Monções;2014;0;0,0;0;0,0;0;0,0
3531209;Monte Alegre do Sul;2014;0;0,0;0;0,0;0;0,0
3531605;Monte Castelo;2014;0;0,0;0;0,0;0;0,0
3531704;Monteiro Lobato;2014;0;0,0;0;0,0;0;0,0
3532058;Motuca;2014;0;0,0;0;0,0;0;0,0
3532108;Murutinga do Sul;2014;0;0,0;0;0,0;0;0,0
3532157;Nantes;2014;0;0,0;0;0,0;0;0,0
3532207;Narandiba;2014;0;0,0;0;0,0;0;0,0
3532306;Natividade da Serra;2014;0;0,0;0;0,0;0;0,0
3532702;Nipoã;2014;0;0,0;0;0,0;0;0,0
3532801;Nova Aliança;2014;0;0,0;0;0,0;0;0,0
3532827;Nova Campina;2014;0;0,0;0;0,0;0;0,0
3532843;Nova Canaã Paulista;2014;0;0,0;0;0,0;0;0,0
3532868;Nova Castilho;2014;0;0,0;0;0,0;0;0,0
3533106;Nova Guataporanga;2014;0;0,0;0;0,0;0;0,0
3533205;Nova Independência;2014;0;0,0;0;0,0;0;0,0
3533254;Novais;2014;0;0,0;0;0,0;0;0,0
3533304;Nova Luzitânia;2014;0;0,0;0;0,0;0;0,0
3533601;Nuporanga;2014;0;0,0;0;0,0;0;0,0
3533700;Ocauçu;2014;0;0,0;0;0,0;0;0,0
3533809;Óleo;2014;0;0,0;0;0,0;0;0,0
3534005;Onda Verde;2014;0;0,0;0;0,0;0;0,0
3534104;Oriente;2014;0;0,0;0;0,0;0;0,0
3534203;Orindiúva;2014;0;0,0;0;0,0;0;0,0
3534500;Oscar Bressane;2014;0;0,0;0;0,0;0;0,0
3534807;Ouro Verde;2014;0;0,0;0;0,0;0;0,0
3535002;Palestina;2014;0;0,0;0;0,0;0;0,0
3535101;Palmares Paulista;2014;0;0,0;0;0,0;0;0,0
3535705;Paraíso;2014;0;0,0;0;0,0;0;0,0
3535903;Paranapuã;2014;0;0,0;0;0,0;0;0,0
3536109;Pardinho;2014;0;0,0;0;0,0;0;0,0
3536257;Parisi;2014;0;0,0;0;0,0;0;0,0
3536406;Paulicéia;2014;0;0,0;0;0,0;0;0,0
3536570;Paulistânia;2014;0;0,0;0;0,0;0;0,0
3536802;Pedra Bela;2014;0;0,0;0;0,0;0;0,0
3536901;Pedranópolis;2014;0;0,0;0;0,0;0;0,0
3537156;Pedrinhas Paulista;2014;0;0,0;0;0,0;0;0,0
3537206;Pedro de Toledo;2014;0;0,0;0;0,0;0;0,0
3537503;Pereiras;2014;0;0,0;0;0,0;0;0,0
3537701;Piacatu;2014;0;0,0;0;0,0;0;0,0
3538105;Pindorama;2014;0;0,0;0;0,0;0;0,0
3538204;Pinhalzinho;2014;0;0,0;0;0,0;0;0,0
3538303;Piquerobi;2014;0;0,0;0;0,0;0;0,0
3538501;Piquete;2014;0;0,0;0;0,0;0;0,0
3539103;Pirapora do Bom Jesus;2014;0;0,0;0;0,0;0;0,0
3539608;Planalto;2014;0;0,0;0;0,0;0;0,0
3539707;Platina;2014;0;0,0;0;0,0;0;0,0
3539905;Poloni;2014;0;0,0;0;0,0;0;0,0
3540101;Pongaí;2014;0;0,0;0;0,0;0;0,0
3540259;Pontalinda;2014;0;0,0;0;0,0;0;0,0
3540309;Pontes Gestal;2014;0;0,0;0;0,0;0;0,0
3540507;Porangaba;2014;0;0,0;0;0,0;0;0,0
3540754;Potim;2014;0;0,0;0;0,0;0;0,0
3540853;Pracinha;2014;0;0,0;0;0,0;0;0,0
3540903;Pradópolis;2014;0;0,0;0;0,0;0;0,0
3541059;Pratânia;2014;0;0,0;0;0,0;0;0,0
3541109;Presidente Alves;2014;0;0,0;0;0,0;0;0,0
3541653;Quadra;2014;0;0,0;0;0,0;0;0,0
3541703;Quatá;2014;0;0,0;0;0,0;0;0,0
3541802;Queiroz;2014;0;0,0;0;0,0;0;0,0
3542008;Quintana;2014;0;0,0;0;0,0;0;0,0
3542107;Rafard;2014;0;0,0;0;0,0;0;0,0
3542305;Redenção da Serra;2014;0;0,0;0;0,0;0;0,0
3542503;Reginópolis;2014;0;0,0;0;0,0;0;0,0
3542701;Restinga;2014;0;0,0;0;0,0;0;0,0
3542800;Ribeira;2014;0;0,0;0;0,0;0;0,0
3543105;Ribeirão Corrente;2014;0;0,0;0;0,0;0;0,0
3543204;Ribeirão do Sul;2014;0;0,0;0;0,0;0;0,0
3543238;Ribeirão dos Índios;2014;0;0,0;0;0,0;0;0,0
3543253;Ribeirão Grande;2014;0;0,0;0;0,0;0;0,0
3543501;Riversul;2014;0;0,0;0;0,0;0;0,0
3543600;Rifaina;2014;0;0,0;0;0,0;0;0,0
3543709;Rincão;2014;0;0,0;0;0,0;0;0,0
3544103;Rio Grande da Serra;2014;0;0,0;0;0,0;0;0,0
3544400;Rubiácea;2014;0;0,0;0;0,0;0;0,0
3544509;Rubinéia;2014;0;0,0;0;0,0;0;0,0
3544608;Sabino;2014;0;0,0;0;0,0;0;0,0
3544707;Sagres;2014;0;0,0;0;0,0;0;0,0
3544806;Sales;2014;0;0,0;0;0,0;0;0,0
3545100;Salmourão;2014;0;0,0;0;0,0;0;0,0
3545159;Saltinho;2014;0;0,0;0;0,0;0;0,0
3545506;Sandovalina;2014;0;0,0;0;0,0;0;0,0
3545704;Santa Albertina;2014;0;0,0;0;0,0;0;0,0
3546009;Santa Branca;2014;0;0,0;0;0,0;0;0,0
3546108;Santa Clara d'Oeste;2014;0;0,0;0;0,0;0;0,0
3546207;Santa Cruz da Conceição;2014;0;0,0;0;0,0;0;0,0
3546256;Santa Cruz da Esperança;2014;0;0,0;0;0,0;0;0,0
3546504;Santa Ernestina;2014;0;0,0;0;0,0;0;0,0
3546702;Santa Gertrudes;2014;0;0,0;0;0,0;0;0,0
3546900;Santa Lúcia;2014;0;0,0;0;0,0;0;0,0
3547106;Santa Mercedes;2014;0;0,0;0;0,0;0;0,0
3547205;Santana da Ponte Pensa;2014;0;0,0;0;0,0;0;0,0
3547403;Santa Rita d'Oeste;2014;0;0,0;0;0,0;0;0,0
3547650;Santa Salete;2014;0;0,0;0;0,0;0;0,0
3548005;Santo Antônio de Posse;2014;0;0,0;0;0,0;0;0,0
3548054;Santo Antônio do Aracanguá;2014;0;0,0;0;0,0;0;0,0
3548104;Santo Antônio do Jardim;2014;0;0,0;0;0,0;0;0,0
3548203;Santo Antônio do Pinhal;2014;0;0,0;0;0,0;0;0,0
3548302;Santo Expedito;2014;0;0,0;0;0,0;0;0,0
3548401;Santópolis do Aguapeí;2014;0;0,0;0;0,0;0;0,0
3549003;São Francisco;2014;0;0,0;0;0,0;0;0,0
3549201;São João das Duas Pontes;2014;0;0,0;0;0,0;0;0,0
3549250;São João de Iracema;2014;0;0,0;0;0,0;0;0,0
3549300;São João do Pau d'Alho;2014;0;0,0;0;0,0;0;0,0
3549508;São José da Bela Vista;2014;0;0,0;0;0,0;0;0,0
3549607;São José do Barreiro;2014;0;0,0;0;0,0;0;0,0
3549953;São Lourenço da Serra;2014;0;0,0;0;0,0;0;0,0
3550506;São Pedro do Turvo;2014;0;0,0;0;0,0;0;0,0
3551108;Sarapuí;2014;0;0,0;0;0,0;0;0,0
3551207;Sarutaiá;2014;0;0,0;0;0,0;0;0,0
3551306;Sebastianópolis do Sul;2014;0;0,0;0;0,0;0;0,0
3551405;Serra Azul;2014;0;0,0;0;0,0;0;0,0
3551801;Sete Barras;2014;0;0,0;0;0,0;0;0,0
3551900;Severínia;2014;0;0,0;0;0,0;0;0,0
3552551;Suzanápolis;2014;0;0,0;0;0,0;0;0,0
3552908;Taciba;2014;0;0,0;0;0,0;0;0,0
3553104;Taiaçu;2014;0;0,0;0;0,0;0;0,0
3553500;Tapiraí;2014;0;0,0;0;0,0;0;0,0
3553658;Taquaral;2014;0;0,0;0;0,0;0;0,0
3553856;Taquarivaí;2014;0;0,0;0;0,0;0;0,0
3553906;Tarabai;2014;0;0,0;0;0,0;0;0,0
3553955;Tarumã;2014;0;0,0;0;0,0;0;0,0
3554201;Tejupá;2014;0;0,0;0;0,0;0;0,0
3554607;Timburi;2014;0;0,0;0;0,0;0;0,0
3554656;Torre de Pedra;2014;0;0,0;0;0,0;0;0,0
3554755;Trabiju;2014;0;0,0;0;0,0;0;0,0
3554904;Três Fronteiras;2014;0;0,0;0;0,0;0;0,0
3554953;Tuiuti;2014;0;0,0;0;0,0;0;0,0
3555208;Turiúba;2014;0;0,0;0;0,0;0;0,0
3555307;Turmalina;2014;0;0,0;0;0,0;0;0,0
3555356;Ubarana;2014;0;0,0;0;0,0;0;0,0
3555505;Ubirajara;2014;0;0,0;0;0,0;0;0,0
3555604;Uchoa;2014;0;0,0;0;0,0;0;0,0
3555703;União Paulista;2014;0;0,0;0;0,0;0;0,0
3555901;Uru;2014;0;0,0;0;0,0;0;0,0
3556107;Valentim Gentil;2014;0;0,0;0;0,0;0;0,0
3556354;Vargem;2014;0;0,0;0;0,0;0;0,0
3556453;Vargem Grande Paulista;2014;0;0,0;0;0,0;0;0,0
3556602;Vera Cruz;2014;0;0,0;0;0,0;0;0,0
3556958;Vitória Brasil;2014;0;0,0;0;0,0;0;0,0
3557154;Zacarias;2014;0;0,0;0;0,0;0;0,0
3557303;Estiva Gerbi;2014;0;0,0;0;0,0;0;0,0
3500600;Águas de São Pedro;2014;4;1,4;4;1,4;0;0,0
3501707;Américo Brasiliense;2014;204;5,5;204;5,5;0;0,0
3503109;Arandu;2014;16;2,6;16;2,6;0;0,0
3504909;Bananal;2014;15;1,4;15;1,4;0;0,0
3506359;Bertioga;2014;46;0,9;46;0,9;0;0,0
3506409;Bilac;2014;36;4,9;36;4,9;0;0,0
3507100;Bom Jesus dos Perdões;2014;11;0,5;11;0,5;0;0,0
3508702;Caconde;2014;64;3,4;64;3,4;0;0,0
3509254;Cajati;2014;13;0,5;13;0,5;0;0,0
3509601;Campo Limpo Paulista;2014;56;0,7;56;0,7;0;0,0
3512308;Conchas;2014;42;2,5;42;2,5;0;0,0
3513900;Divinolândia;2014;198;17,9;198;17,9;0;0,0
3514809;Eldorado;2014;2;0,1;2;0,1;0;0,0
3514908;Elias Fausto;2014;6;0,4;6;0,4;0;0,0
3515004;Embu das Artes;2014;72;0,3;72;0,3;0;0,0
3515103;Embu-Guaçu;2014;16;0,2;16;0,2;0;0,0
3515707;Ferraz de Vasconcelos;2014;258;1,4;258;1,4;0;0,0
3517604;Guapiara;2014;19;1,1;19;1,1;0;0,0
3519006;Herculândia;2014;32;3,6;32;3,6;0;0,0
3519303;Ibaté;2014;32;1,0;32;1,0;0;0,0
3519907;Iepê;2014;20;2,6;20;2,6;0;0,0
3520202;Igaratá;2014;15;1,7;15;1,7;0;0,0
3520301;Iguape;2014;13;0,4;13;0,4;0;0,0
3521002;Iperó;2014;15;0,5;15;0,5;0;0,0
3522109;Itanhaém;2014;74;0,8;74;0,8;0;0,0
3523107;Itaquaquecetuba;2014;224;0,7;224;0,7;0;0,0
3523602;Itirapina;2014;8;0,5;8;0,5;0;0,0
3524204;Jaborandi;2014;17;2,6;17;2,6;0;0,0
3526100;Juquiá;2014;15;0,8;15;0,8;0;0,0
3528502;Mairiporã;2014;47;0,5;47;0,5;0;0,0
3528809;Maracaí;2014;26;1,9;26;1,9;0;0,0
3530102;Mirandópolis;2014;90;3,2;90;3,2;0;0,0
3531100;Mongaguá;2014;44;0,9;44;0,9;0;0,0
3532009;Morungaba;2014;13;1,1;13;1,1;0;0,0
3532405;Nazaré Paulista;2014;24;1,4;24;1,4;0;0,0
3533403;Nova Odessa;2014;53;1,0;53;1,0;0;0,0
3535804;Paranapanema;2014;30;1,6;30;1,6;0;0,0
3536208;Pariquera-Açu;2014;151;8,0;151;8,0;0;0,0
3536505;Paulínia;2014;84;0,9;84;0,9;0;0,0
3537107;Pedreira;2014;49;1,1;49;1,1;0;0,0
3537602;Peruíbe;2014;39;0,6;39;0,6;0;0,0
3539202;Pirapozinho;2014;59;2,3;59;2,3;0;0,0
3539806;Poá;2014;30;0,3;30;0,3;0;0,0
3540002;Pompéia;2014;41;2,0;41;2,0;0;0,0
3541604;Promissão;2014;75;2,0;75;2,0;0;0,0
3541901;Queluz;2014;26;2,2;26;2,2;0;0,0
3544251;Rosana;2014;57;3,0;57;3,0;0;0,0
3544301;Roseira;2014;14;1,4;14;1,4;0;0,0
3547007;Santa Maria da Serra;2014;8;1,4;8;1,4;0;0,0
3547304;Santana de Parnaíba;2014;16;0,1;16;0,1;0;0,0
3547908;Santo Antônio da Alegria;2014;12;1,9;12;1,9;0;0,0
3550209;São Miguel Arcanjo;2014;25;0,8;25;0,8;0;0,0
3552007;Silveiras;2014;3;0,5;3;0,5;0;0,0
3552304;Sud Mennucci;2014;20;2,6;20;2,6;0;0,0
3553203;Taiúva;2014;4;0,6;4;0,6;0;0,0
3556909;Vista Alegre do Alto;2014;9;1,2;9;1,2;0;0,0
3507407;Borborema;2014;27;1,8;17;1,1;10;0,7
3511904;Clementina;2014;30;3,9;20;2,6;10;1,3
3512100;Colômbia;2014;30;5,0;20;3,3;10;1,7
3521309;Ipuã;2014;49;3,3;39;2,6;10;0,7
3538907;Pirajuí;2014;299;13,0;289;12,6;10;0,4
3541307;Presidente Epitácio;2014;78;1,9;68;1,6;10;0,2
3544905;Sales Oliveira;2014;29;2,6;19;1,7;10;0,9
3505807;Bastos;2014;35;1,7;28;1,4;7;0,3
3508603;Cachoeira Paulista;2014;47;1,5;40;1,3;7;0,2
3511706;Charqueada;2014;33;2,1;26;1,6;7;0,4
3512001;Colina;2014;47;2,7;40;2,3;7;0,4
3517802;Guaraçaí;2014;27;3,2;20;2,4;7;0,8
3523503;Itatinga;2014;14;0,7;7;0,4;7;0,4
3525508;Joanópolis;2014;24;2,0;17;1,4;7;0,6
3527306;Louveira;2014;41;1,0;34;0,8;7;0,2
3531803;Monte Mor;2014;36;0,7;29;0,5;7;0,1
3542404;Regente Feijó;2014;24;1,3;17;0,9;7;0,4
3550100;São Manuel;2014;43;1,1;36;0,9;7;0,2
3554706;Torrinha;2014;20;2,1;13;1,4;7;0,7
3501004;Altinópolis;2014;31;2,0;25;1,6;6;0,4
3502705;Apiaí;2014;51;2,1;45;1,8;6;0,2
3507902;Brotas;2014;41;1,8;35;1,6;6;0,3
3509304;Cajobi;2014;32;3,2;26;2,6;6;0,6
3514304;Dourado;2014;18;2,1;12;1,4;6;0,7
3518305;Guararema;2014;35;1,3;29;1,1;6;0,2
3536000;Parapuã;2014;32;3,0;26;2,4;6;0,6
3542909;Ribeirão Bonito;2014;17;1,4;11;0,9;6;0,5
3553609;Tapiratiba;2014;24;1,9;18;1,4;6;0,5
3554300;Teodoro Sampaio;2014;58;2,7;52;2,4;6;0,3
3508405;Cabreúva;2014;36;0,8;28;0,6;8;0,2
3517703;Guará;2014;30;1,5;22;1,1;8;0,4
3520004;Igaraçu do Tietê;2014;63;2,7;55;2,3;8;0,3
3537909;Pilar do Sul;2014;35;1,3;27;1,0;8;0,3
3538600;Piracaia;2014;37;1,4;29;1,1;8;0,3
3543808;Rinópolis;2014;33;3,4;25;2,5;8;0,8
3550704;São Sebastião;2014;101;1,3;93;1,2;8;0,1
3550902;São Simão;2014;40;2,8;32;2,2;8;0,6
3552106;Socorro;2014;62;1,6;54;1,4;8;0,2
3510005;Cândido Mota;2014;30;1,0;25;0,8;5;0,2
3514502;Duartina;2014;82;6,8;77;6,3;5;0,4
3521705;Itaberá;2014;70;4,0;65;3,7;5;0,3
3532900;Nova Europa;2014;12;1,2;7;0,7;5;0,5
3534906;Pacaembu;2014;37;2,8;32;2,4;5;0,4
3553005;Taguaí;2014;29;2,4;24;2,0;5;0,4
3501301;Álvares Machado;2014;20;0,8;18;0,8;2;0,1
3506706;Boa Esperança do Sul;2014;15;1,1;13;0,9;2;0,1
3513108;Cravinhos;2014;15;0,5;13;0,4;2;0,1
3519105;Iacanga;2014;27;2,6;25;2,4;2;0,2
3524709;Jaguariúna;2014;80;1,6;78;1,6;2;0,0
3535606;Paraibuna;2014;14;0,8;12;0,7;2;0,1
3555802;Urânia;2014;26;3,0;24;2,7;2;0,2
3556503;Várzea Paulista;2014;29;0,3;27;0,2;2;0,0
3556701;Vinhedo;2014;6;0,1;4;0,1;2;0,0
3519402;Ibirá;2014;27;2,4;8;0,7;19;1,7
3522802;Itaporanga;2014;46;3,2;27;1,9;19;1,3
3529708;Miguelópolis;2014;66;3,2;47;2,3;19;0,9
3531506;Monte Azul Paulista;2014;70;3,8;51;2,7;19;1,0
3535507;Paraguaçu Paulista;2014;97;2,3;78;1,8;19;0,4
3546801;Santa Isabel;2014;101;1,9;82;1,6;19;0,4
3547700;Santo Anastácio;2014;56;2,8;37;1,8;19;0,9
3509403;Cajuru;2014;73;3,0;55;2,3;18;0,7
3510203;Capão Bonito;2014;67;1,5;49;1,1;18;0,4
3511409;Cerqueira César;2014;51;2,8;33;1,8;18;1,0
3517406;Guaíra;2014;60;1,6;42;1,1;18;0,5
3520103;Igarapava;2014;50;1,7;32;1,1;18;0,6
3538808;Piraju;2014;72;2,5;54;1,9;18;0,6
3539509;Pitangueiras;2014;50;1,4;32;0,9;18;0,5
3503802;Artur Nogueira;2014;12;0,3;0;0,0;12;0,3
3511508;Cerquilho;2014;43;1,0;31;0,7;12;0,3
3536307;Patrocínio Paulista;2014;35;2,6;23;1,7;12;0,9
3540408;Populina;2014;18;4,4;6;1,5;12;2,9
3540606;Porto Feliz;2014;51;1,0;39;0,8;12;0,2
3545407;Salto Grande;2014;34;3,8;22;2,5;12;1,3
3547601;Santa Rosa de Viterbo;2014;30;1,2;18;0,7;12;0,5
3502754;Araçariguama;2014;4;0,2;0;0,0;4;0,2
3513504;Cubatão;2014;138;1,1;134;1,1;4;0,0
3519204;Iacri;2014;19;3,0;15;2,4;4;0,6
3519709;Ibiúna;2014;67;0,9;63;0,9;4;0,1
3539400;Piratininga;2014;30;2,4;26;2,1;4;0,3
3550803;São Sebastião da Grama;2014;30;2,5;26;2,2;4;0,3
3501103;Alto Alegre;2014;22;5,4;19;4,7;3;0,7
3502200;Angatuba;2014;57;2,5;54;2,3;3;0,1
3520400;Ilhabela;2014;40;1,3;37;1,2;3;0,1
3540804;Potirendaba;2014;31;1,9;28;1,8;3;0,2
3545001;Salesópolis;2014;24;1,5;21;1,3;3;0,2
3503406;Arealva;2014;28;3,5;17;2,1;11;1,4
3508801;Cafelândia;2014;58;3,4;47;2,8;11;0,7
3512209;Conchal;2014;52;2,0;41;1,6;11;0,4
3522901;Itapuí;2014;33;2,6;22;1,7;11;0,9
3528106;Macaubal;2014;24;3,1;13;1,7;11;1,4
3541208;Presidente Bernardes;2014;51;3,7;40;2,9;11;0,8
3553302;Tambaú;2014;36;1,6;25;1,1;11;0,5
3511607;Cesário Lange;2014;30;1,8;17;1,0;13;0,8
3528007;Macatuba;2014;31;1,9;18;1,1;13;0,8
3552700;Tabatinga;2014;35;2,3;22;1,4;13;0,9
3503703;Ariranha;2014;25;2,8;4;0,5;21;2,4
3516606;Gália;2014;45;6,6;24;3,5;21;3,1
3525201;Jarinu;2014;33;1,3;12;0,5;21;0,8
3525706;José Bonifácio;2014;61;1,8;40;1,2;21;0,6
3546306;Santa Cruz das Palmeiras;2014;46;1,5;25;0,8;21;0,7
3552601;Tabapuã;2014;30;2,6;9;0,8;21;1,8
3553807;Taquarituba;2014;53;2,3;32;1,4;21;0,9
3556008;Urupês;2014;34;2,6;13;1,0;21;1,6
3515400;Fartura;2014;26;1,7;17;1,1;9;0,6
3517000;Getulina;2014;51;4,7;42;3,9;9;0,8
3526209;Juquitiba;2014;9;0,3;0;0,0;9;0,3
3555406;Ubatuba;2014;76;0,9;67;0,8;9;0,1
3508108;Buritama;2014;42;2,6;22;1,4;20;1,3
3514106;Dois Córregos;2014;67;2,6;47;1,8;20;0,8
3520905;Ipaussu;2014;49;3,5;29;2,1;20;1,4
3527405;Lucélia;2014;58;2,8;38;1,9;20;1,0
3533908;Olímpia;2014;99;1,9;79;1,5;20;0,4
3536604;Paulo de Faria;2014;24;2,8;4;0,5;20;2,3
3536703;Pederneiras;2014;72;1,7;52;1,2;20;0,5
3537008;Pedregulho;2014;53;3,3;33;2,1;20;1,3
3545605;Santa Adélia;2014;31;2,1;11;0,8;20;1,4
3513603;Cunha;2014;44;2,0;29;1,3;15;0,7
3513702;Descalvado;2014;38;1,2;23;0,7;15;0,5
3523206;Itararé;2014;93;1,9;78;1,6;15;0,3
3526407;Laranjal Paulista;2014;47;1,8;32;1,2;15;0,6
3544004;Rio das Pedras;2014;53;1,7;38;1,2;15;0,5
3550001;São Luiz do Paraitinga;2014;26;2,5;11;1,1;15;1,4
3551504;Serrana;2014;58;1,4;43;1,0;15;0,4
3500105;Adamantina;2014;279;8,2;240;7,1;39;1,2
3500709;Agudos;2014;60;1,7;38;1,1;22;0,6
3501608;Americana;2014;702;3,2;340;1,5;362;1,6
3501905;Amparo;2014;358;5,3;243;3,6;115;1,7
3502101;Andradina;2014;135;2,4;110;2,0;25;0,4
3502507;Aparecida;2014;104;2,9;70;2,0;34;1,0
3502606;Aparecida d'Oeste;2014;30;6,9;8;1,9;22;5,1
3502804;Araçatuba;2014;616;3,3;478;2,6;138;0,7
3502903;Araçoiaba da Serra;2014;126;4,3;0;0,0;126;4,3
3503208;Araraquara;2014;576;2,7;262;1,2;314;1,4
3503307;Araras;2014;565;4,6;307;2,5;258;2,1
3503901;Arujá;2014;82;1,0;15;0,2;67;0,8
3504008;Assis;2014;314;3,2;195;2,0;119;1,2
3504107;Atibaia;2014;300;2,3;55;0,4;245;1,9
3504503;Avaré;2014;153;1,8;95;1,1;58;0,7
3505203;Bariri;2014;68;2,1;52;1,6;16;0,5
3505302;Barra Bonita;2014;101;2,9;68;1,9;33;0,9
3505500;Barretos;2014;604;5,3;501;4,4;103;0,9
3505708;Barueri;2014;497;2,0;401;1,6;96;0,4
3505906;Batatais;2014;139;2,4;94;1,6;45;0,8
3506003;Bauru;2014;1.128;3,2;723;2,1;405;1,1
3506102;Bebedouro;2014;129;1,7;81;1,1;48;0,6
3506300;Bernardino de Campos;2014;50;4,6;20;1,9;30;2,8
3506508;Birigui;2014;242;2,1;155;1,4;87;0,8
3507001;Boituva;2014;55;1,1;39;0,7;16;0,3
3507506;Botucatu;2014;604;4,5;497;3,7;107;0,8
3507605;Bragança Paulista;2014;333;2,2;230;1,5;103;0,7
3508504;Caçapava;2014;145;1,7;77;0,9;68;0,8
3509007;Caieiras;2014;112;1,2;58;0,6;54;0,6
3509205;Cajamar;2014;171;2,5;71;1,0;100;1,4
3509502;Campinas;2014;2.959;2,6;1.445;1,3;1.514;1,3
3509700;Campos do Jordão;2014;242;5,0;195;4,0;47;1,0
3510401;Capivari;2014;96;1,9;46;0,9;50;1,0
3510500;Caraguatatuba;2014;158;1,5;120;1,1;38;0,4
3510609;Carapicuíba;2014;353;0,9;263;0,7;90;0,2
3510708;Cardoso;2014;31;2,6;14;1,2;17;1,4
3510807;Casa Branca;2014;412;14,3;395;13,7;17;0,6
3511102;Catanduva;2014;514;4,5;373;3,2;141;1,2
3512803;Cosmópolis;2014;90;1,4;63;1,0;27;0,4
3513009;Cotia;2014;287;1,3;109;0,5;178;0,8
3513405;Cruzeiro;2014;156;2,0;111;1,4;45;0,6
3513801;Diadema;2014;635;1,6;566;1,4;69;0,2
3514403;Dracena;2014;143;3,2;108;2,5;35;0,8
3515186;Espírito Santo do Pinhal;2014;458;10,8;369;8,7;89;2,1
3515509;Fernandópolis;2014;180;2,8;90;1,4;90;1,4
3516200;Franca;2014;720;2,2;456;1,4;264;0,8
3516309;Francisco Morato;2014;144;0,9;111;0,7;33;0,2
3516408;Franco da Rocha;2014;719;5,1;427;3,1;292;2,1
3516705;Garça;2014;376;8,8;331;7,7;45;1,1
3516903;General Salgado;2014;32;3,0;8;0,7;24;2,2
3518404;Guaratinguetá;2014;303;2,6;210;1,8;93;0,8
3518602;Guariba;2014;72;1,9;50;1,4;22;0,6
3518701;Guarujá;2014;331;1,1;263;0,9;68;0,2
3518800;Guarulhos;2014;1.846;1,4;1.428;1,1;418;0,3
3519071;Hortolândia;2014;91;0,4;62;0,3;29;0,1
3519600;Ibitinga;2014;99;1,8;46;0,8;53;1,0
3520442;Ilha Solteira;2014;116;4,6;74;2,9;42;1,7
3520509;Indaiatuba;2014;372;1,7;268;1,2;104;0,5
3520707;Indiaporã;2014;40;10,3;5;1,3;35;9,0
3521804;Itaí;2014;41;1,6;40;1,6;1;0,0
3521903;Itajobi;2014;30;2,1;13;0,9;17;1,2
3522208;Itapecerica da Serra;2014;444;2,8;197;1,2;247;1,5
3522307;Itapetininga;2014;129;0,9;107;0,7;22;0,1
3522406;Itapeva;2014;164;1,8;122;1,4;42;0,5
3522505;Itapevi;2014;269;1,3;205;1,0;64;0,3
3522604;Itapira;2014;1.276;18,2;737;10,5;539;7,7
3522703;Itápolis;2014;76;1,9;45;1,1;31;0,8
3523404;Itatiba;2014;112;1,0;60;0,6;52;0,5
3523909;Itu;2014;426;2,7;391;2,4;35;0,2
3524006;Itupeva;2014;86;1,7;48;0,9;38;0,8
3524105;Ituverava;2014;120;3,0;58;1,5;62;1,6
3524303;Jaboticabal;2014;143;2,0;56;0,8;87;1,2
3524402;Jacareí;2014;421;1,9;211;1,0;210;1,0
3524501;Jaci;2014;179;28,9;151;24,4;28;4,5
3524808;Jales;2014;165;3,5;112;2,4;53;1,1
3525003;Jandira;2014;40;0,3;26;0,2;14;0,1
3525300;Jaú;2014;860;6,2;705;5,1;155;1,1
3525904;Jundiaí;2014;695;1,8;321;0,8;374;1,0
3526001;Junqueirópolis;2014;52;2,7;26;1,3;26;1,3
3526704;Leme;2014;127;1,3;76;0,8;51;0,5
3526803;Lençóis Paulista;2014;80;1,3;57;0,9;23;0,4
3526902;Limeira;2014;407;1,4;216;0,8;191;0,7
3527108;Lins;2014;446;6,1;349;4,8;97;1,3
3527207;Lorena;2014;165;2,0;84;1,0;81;1,0
3527702;Luiziânia;2014;32;6,0;15;2,8;17;3,2
3529005;Marília;2014;860;3,9;729;3,3;131;0,6
3529203;Martinópolis;2014;66;2,7;41;1,7;25;1,0
3529302;Matão;2014;169;2,2;101;1,3;68;0,9
3529401;Mauá;2014;592;1,4;316;0,7;276;0,6
3530300;Mirassol;2014;93;1,7;29;0,5;64;1,2
3530508;Mococa;2014;135;2,0;86;1,3;49;0,7
3530607;Mogi das Cruzes;2014;832;2,0;607;1,5;225;0,6
3530706;Mogi Guaçu;2014;333;2,3;154;1,1;179;1,3
3530805;Mogi Mirim;2014;254;2,9;131;1,5;123;1,4
3531308;Monte Alto;2014;109;2,3;58;1,2;51;1,1
3531902;Morro Agudo;2014;45;1,5;31;1,0;14;0,5
3532504;Neves Paulista;2014;35;4,0;11;1,3;24;2,8
3532603;Nhandeara;2014;129;12,0;37;3,4;92;8,5
3533007;Nova Granada;2014;193;9,7;37;1,9;156;7,8
3533502;Novo Horizonte;2014;105;2,8;35;0,9;70;1,9
3534302;Orlândia;2014;98;2,4;59;1,4;39;1,0
3534401;Osasco;2014;992;1,5;592;0,9;400;0,6
3534609;Osvaldo Cruz;2014;90;2,9;59;1,9;31;1,0
3534708;Ourinhos;2014;315;3,0;230;2,2;85;0,8
3534757;Ouroeste;2014;39;4,3;10;1,1;29;3,2
3535200;Palmeira d'Oeste;2014;24;2,6;10;1,1;14;1,5
3535309;Palmital;2014;68;3,2;44;2,1;24;1,1
3535408;Panorama;2014;36;2,4;35;2,4;1;0,1
3537305;Penápolis;2014;238;4,0;168;2,8;70;1,2
3537404;Pereira Barreto;2014;98;3,9;65;2,6;33;1,3
3537800;Piedade;2014;521;9,9;471;8,9;50;0,9
3538006;Pindamonhangaba;2014;199;1,3;127;0,8;72;0,5
3538709;Piracicaba;2014;801;2,1;309;0,8;492;1,3
3539004;Pirangi;2014;41;3,8;9;0,8;32;3,0
3539301;Pirassununga;2014;91;1,3;55;0,8;36;0,5
3540200;Pontal;2014;45;1,0;29;0,7;16;0,4
3540705;Porto Ferreira;2014;61;1,2;37;0,7;24;0,5
3541000;Praia Grande;2014;189;0,7;113;0,4;76;0,3
3541406;Presidente Prudente;2014;1.538;7,2;1.088;5,1;450;2,1
3541505;Presidente Venceslau;2014;97;2,6;75;2,0;22;0,6
3542206;Rancharia;2014;98;3,4;70;2,4;28;1,0
3542602;Registro;2014;105;1,9;63;1,2;42;0,8
3543006;Ribeirão Branco;2014;36;2,0;35;2,0;1;0,1
3543303;Ribeirão Pires;2014;164;1,4;50;0,4;114;1,0
3543402;Ribeirão Preto;2014;2.051;3,2;1.387;2,2;664;1,0
3543907;Rio Claro;2014;482;2,5;278;1,4;204;1,1
3544202;Riolândia;2014;36;3,3;7;0,6;29;2,7
3545209;Salto;2014;123;1,1;70;0,6;53;0,5
3545308;Salto de Pirapora;2014;1.026;24,5;1.000;23,9;26;0,6
3545803;Santa Bárbara d'Oeste;2014;159;0,9;100;0,5;59;0,3
3546405;Santa Cruz do Rio Pardo;2014;100;2,2;65;1,5;35;0,8
3546603;Santa Fé do Sul;2014;76;2,5;33;1,1;43;1,4
3547502;Santa Rita do Passa Quatro;2014;299;11,3;276;10,4;23;0,9
3547809;Santo André;2014;1.548;2,3;698;1,0;850;1,2
3548500;Santos;2014;1.662;3,9;800;1,9;862;2,0
3548609;São Bento do Sapucaí;2014;40;3,8;26;2,5;14;1,3
3548708;São Bernardo do Campo;2014;1.534;2,0;566;0,7;968;1,2
3548807;São Caetano do Sul;2014;560;3,7;182;1,2;378;2,5
3548906;São Carlos;2014;419;1,8;204;0,9;215;0,9
3549102;São João da Boa Vista;2014;198;2,3;94;1,1;104;1,2
3549409;São Joaquim da Barra;2014;115;2,4;68;1,4;47;1,0
3549706;São José do Rio Pardo;2014;145;2,8;89;1,7;56;1,1
3549805;São José do Rio Preto;2014;1.784;4,2;997;2,3;787;1,8
3549904;São José dos Campos;2014;1.502;2,3;834;1,3;668;1,0
3550308;São Paulo;2014;29.327;2,5;15.084;1,3;14.243;1,2
3550407;São Pedro;2014;62;1,9;37;1,1;25;0,8
3550605;São Roque;2014;103;1,2;54;0,7;49;0,6
3551009;São Vicente;2014;287;0,8;170;0,5;117;0,3
3551603;Serra Negra;2014;49;1,8;33;1,2;16;0,6
3551702;Sertãozinho;2014;157;1,4;64;0,6;93;0,8
3552205;Sorocaba;2014;2.223;3,6;1.516;2,5;707;1,1
3552403;Sumaré;2014;189;0,7;172;0,7;17;0,1
3552502;Suzano;2014;173;0,6;88;0,3;85;0,3
3552809;Taboão da Serra;2014;570;2,2;339;1,3;231;0,9
3553401;Tanabi;2014;72;2,9;36;1,5;36;1,5
3553708;Taquaritinga;2014;124;2,3;73;1,3;51;0,9
3554003;Tatuí;2014;205;1,8;85;0,8;120;1,1
3554102;Taubaté;2014;467;1,6;325;1,1;142;0,5
3554508;Tietê;2014;69;1,8;42;1,1;27;0,7
3554805;Tremembé;2014;41;1,0;0;0,0;41;1,0
3555000;Tupã;2014;864;13,7;791;12,5;73;1,2
3556206;Valinhos;2014;169;1,5;63;0,5;106;0,9
3556305;Valparaíso;2014;55;2,4;31;1,3;24;1,0
3556404;Vargem Grande do Sul;2014;77;1,9;47;1,2;30;0,7
3557006;Votorantim;2014;150;1,3;88;0,8;62;0,5
3557105;Votuporanga;2014;238;2,7;123;1,4;115;1,3
3500501;Águas de Lindóia;2014;42;2,4;30;1,7;12;0,7
3504206;Auriflama;2014;51;3,6;30;2,1;21;1,5
3506805;Bocaina;2014;35;3,1;30;2,6;5;0,4
3511003;Castilho;2014;31;1,6;30;1,6;1;0,1
3515202;Estrela d'Oeste;2014;50;6,1;30;3,7;20;2,4
3516002;Flórida Paulista;2014;47;3,8;30;2,4;17;1,4
3518206;Guararapes;2014;74;2,4;30;1,0;44;1,4
3531407;Monte Aprazível;2014;80;3,5;30;1,3;50;2,2
3554409;Terra Roxa;2014;34;3,9;30;3,4;4;0,5
3555109;Tupi Paulista;2014;48;3,3;30;2,0;18;1,2
3556800;Viradouro;2014;48;2,7;30;1,7;18;1,0
3557204;Chavantes;2014;50;4,1;30;2,5;20;1,6
3500204;Adolfo;2013;0;0,0;0;0,0;0;0,0
3500303;Aguaí;2013;0;0,0;0;0,0;0;0,0
3500402;Águas da Prata;2013;0;0,0;0;0,0;0;0,0
3500550;Águas de Santa Bárbara;2013;0;0,0;0;0,0;0;0,0
3500758;Alambari;2013;0;0,0;0;0,0;0;0,0
3500808;Alfredo Marcondes;2013;0;0,0;0;0,0;0;0,0
3500907;Altair;2013;0;0,0;0;0,0;0;0,0
3501152;Alumínio;2013;0;0,0;0;0,0;0;0,0
3501202;Álvares Florence;2013;0;0,0;0;0,0;0;0,0
3501400;Álvaro de Carvalho;2013;0;0,0;0;0,0;0;0,0
3501509;Alvinlândia;2013;0;0,0;0;0,0;0;0,0
3501806;Américo de Campos;2013;0;0,0;0;0,0;0;0,0
3502002;Analândia;2013;0;0,0;0;0,0;0;0,0
3502309;Anhembi;2013;0;0,0;0;0,0;0;0,0
3502408;Anhumas;2013;0;0,0;0;0,0;0;0,0
3503000;Aramina;2013;0;0,0;0;0,0;0;0,0
3503158;Arapeí;2013;0;0,0;0;0,0;0;0,0
3503356;Arco-Íris;2013;0;0,0;0;0,0;0;0,0
3503505;Areias;2013;0;0,0;0;0,0;0;0,0
3503604;Areiópolis;2013;0;0,0;0;0,0;0;0,0
3503950;Aspásia;2013;0;0,0;0;0,0;0;0,0
3504305;Avaí;2013;0;0,0;0;0,0;0;0,0
3504404;Avanhandava;2013;0;0,0;0;0,0;0;0,0
3504602;Bady Bassitt;2013;0;0,0;0;0,0;0;0,0
3504701;Balbinos;2013;0;0,0;0;0,0;0;0,0
3504800;Bálsamo;2013;0;0,0;0;0,0;0;0,0
3505005;Barão de Antonina;2013;0;0,0;0;0,0;0;0,0
3505104;Barbosa;2013;0;0,0;0;0,0;0;0,0
3505351;Barra do Chapéu;2013;0;0,0;0;0,0;0;0,0
3505401;Barra do Turvo;2013;0;0,0;0;0,0;0;0,0
3506201;Bento de Abreu;2013;0;0,0;0;0,0;0;0,0
3506607;Biritiba Mirim;2013;0;0,0;0;0,0;0;0,0
3506904;Bofete;2013;0;0,0;0;0,0;0;0,0
3507159;Bom Sucesso de Itararé;2013;0;0,0;0;0,0;0;0,0
3507209;Borá;2013;0;0,0;0;0,0;0;0,0
3507308;Boracéia;2013;0;0,0;0;0,0;0;0,0
3507456;Borebi;2013;0;0,0;0;0,0;0;0,0
3507704;Braúna;2013;0;0,0;0;0,0;0;0,0
3507753;Brejo Alegre;2013;0;0,0;0;0,0;0;0,0
3507803;Brodowski;2013;0;0,0;0;0,0;0;0,0
3508009;Buri;2013;0;0,0;0;0,0;0;0,0
3508207;Buritizal;2013;0;0,0;0;0,0;0;0,0
3508306;Cabrália Paulista;2013;0;0,0;0;0,0;0;0,0
3508900;Caiabu;2013;0;0,0;0;0,0;0;0,0
3509106;Caiuá;2013;0;0,0;0;0,0;0;0,0
3509452;Campina do Monte Alegre;2013;0;0,0;0;0,0;0;0,0
3509809;Campos Novos Paulista;2013;0;0,0;0;0,0;0;0,0
3509908;Cananéia;2013;0;0,0;0;0,0;0;0,0
3509957;Canas;2013;0;0,0;0;0,0;0;0,0
3510104;Cândido Rodrigues;2013;0;0,0;0;0,0;0;0,0
3510153;Canitar;2013;0;0,0;0;0,0;0;0,0
3510302;Capela do Alto;2013;0;0,0;0;0,0;0;0,0
3510906;Cássia dos Coqueiros;2013;0;0,0;0;0,0;0;0,0
3511201;Catiguá;2013;0;0,0;0;0,0;0;0,0
3511300;Cedral;2013;0;0,0;0;0,0;0;0,0
3512407;Cordeirópolis;2013;0;0,0;0;0,0;0;0,0
3512506;Coroados;2013;0;0,0;0;0,0;0;0,0
3512605;Coronel Macedo;2013;0;0,0;0;0,0;0;0,0
3512704;Corumbataí;2013;0;0,0;0;0,0;0;0,0
3512902;Cosmorama;2013;0;0,0;0;0,0;0;0,0
3513207;Cristais Paulista;2013;0;0,0;0;0,0;0;0,0
3513306;Cruzália;2013;0;0,0;0;0,0;0;0,0
3513850;Dirce Reis;2013;0;0,0;0;0,0;0;0,0
3514007;Dobrada;2013;0;0,0;0;0,0;0;0,0
3514205;Dolcinópolis;2013;0;0,0;0;0,0;0;0,0
3514601;Dumont;2013;0;0,0;0;0,0;0;0,0
3514700;Echaporã;2013;0;0,0;0;0,0;0;0,0
3514924;Elisiário;2013;0;0,0;0;0,0;0;0,0
3514957;Embaúba;2013;0;0,0;0;0,0;0;0,0
3515129;Emilianópolis;2013;0;0,0;0;0,0;0;0,0
3515152;Engenheiro Coelho;2013;0;0,0;0;0,0;0;0,0
3515194;Espírito Santo do Turvo;2013;0;0,0;0;0,0;0;0,0
3515301;Estrela do Norte;2013;0;0,0;0;0,0;0;0,0
3515350;Euclides da Cunha Paulista;2013;0;0,0;0;0,0;0;0,0
3515608;Fernando Prestes;2013;0;0,0;0;0,0;0;0,0
3515657;Fernão;2013;0;0,0;0;0,0;0;0,0
3515806;Flora Rica;2013;0;0,0;0;0,0;0;0,0
3515905;Floreal;2013;0;0,0;0;0,0;0;0,0
3516101;Florínea;2013;0;0,0;0;0,0;0;0,0
3516507;Gabriel Monteiro;2013;0;0,0;0;0,0;0;0,0
3516804;Gastão Vidigal;2013;0;0,0;0;0,0;0;0,0
3516853;Gavião Peixoto;2013;0;0,0;0;0,0;0;0,0
3517109;Glicério;2013;0;0,0;0;0,0;0;0,0
3517208;Guaiçara;2013;0;0,0;0;0,0;0;0,0
3517307;Guaimbê;2013;0;0,0;0;0,0;0;0,0
3517505;Guapiaçu;2013;0;0,0;0;0,0;0;0,0
3517901;Guaraci;2013;0;0,0;0;0,0;0;0,0
3518008;Guarani d'Oeste;2013;0;0,0;0;0,0;0;0,0
3518107;Guarantã;2013;0;0,0;0;0,0;0;0,0
3518503;Guareí;2013;0;0,0;0;0,0;0;0,0
3518859;Guatapará;2013;0;0,0;0;0,0;0;0,0
3518909;Guzolândia;2013;0;0,0;0;0,0;0;0,0
3519055;Holambra;2013;0;0,0;0;0,0;0;0,0
3519253;Iaras;2013;0;0,0;0;0,0;0;0,0
3519501;Ibirarema;2013;0;0,0;0;0,0;0;0,0
3519808;Icém;2013;0;0,0;0;0,0;0;0,0
3520426;Ilha Comprida;2013;0;0,0;0;0,0;0;0,0
3520608;Indiana;2013;0;0,0;0;0,0;0;0,0
3520806;Inúbia Paulista;2013;0;0,0;0;0,0;0;0,0
3521101;Ipeúna;2013;0;0,0;0;0,0;0;0,0
3521150;Ipiguá;2013;0;0,0;0;0,0;0;0,0
3521200;Iporanga;2013;0;0,0;0;0,0;0;0,0
3521408;Iracemápolis;2013;0;0,0;0;0,0;0;0,0
3521507;Irapuã;2013;0;0,0;0;0,0;0;0,0
3521606;Irapuru;2013;0;0,0;0;0,0;0;0,0
3522000;Itaju;2013;0;0,0;0;0,0;0;0,0
3522158;Itaoca;2013;0;0,0;0;0,0;0;0,0
3522653;Itapirapuã Paulista;2013;0;0,0;0;0,0;0;0,0
3523008;Itapura;2013;0;0,0;0;0,0;0;0,0
3523305;Itariri;2013;0;0,0;0;0,0;0;0,0
3523701;Itirapuã;2013;0;0,0;0;0,0;0;0,0
3523800;Itobi;2013;0;0,0;0;0,0;0;0,0
3524600;Jacupiranga;2013;0;0,0;0;0,0;0;0,0
3524907;Jambeiro;2013;0;0,0;0;0,0;0;0,0
3525102;Jardinópolis;2013;0;0,0;0;0,0;0;0,0
3525409;Jeriquara;2013;0;0,0;0;0,0;0;0,0
3525607;João Ramalho;2013;0;0,0;0;0,0;0;0,0
3525805;Júlio Mesquita;2013;0;0,0;0;0,0;0;0,0
3525854;Jumirim;2013;0;0,0;0;0,0;0;0,0
3526308;Lagoinha;2013;0;0,0;0;0,0;0;0,0
3526506;Lavínia;2013;0;0,0;0;0,0;0;0,0
3526605;Lavrinhas;2013;0;0,0;0;0,0;0;0,0
3527009;Lindóia;2013;0;0,0;0;0,0;0;0,0
3527256;Lourdes;2013;0;0,0;0;0,0;0;0,0
3527504;Lucianópolis;2013;0;0,0;0;0,0;0;0,0
3527603;Luís Antônio;2013;0;0,0;0;0,0;0;0,0
3527801;Lupércio;2013;0;0,0;0;0,0;0;0,0
3527900;Lutécia;2013;0;0,0;0;0,0;0;0,0
3528205;Macedônia;2013;0;0,0;0;0,0;0;0,0
3528304;Magda;2013;0;0,0;0;0,0;0;0,0
3528403;Mairinque;2013;0;0,0;0;0,0;0;0,0
3528601;Manduri;2013;0;0,0;0;0,0;0;0,0
3528700;Marabá Paulista;2013;0;0,0;0;0,0;0;0,0
3528858;Marapoama;2013;0;0,0;0;0,0;0;0,0
3528908;Mariápolis;2013;0;0,0;0;0,0;0;0,0
3529104;Marinópolis;2013;0;0,0;0;0,0;0;0,0
3529500;Mendonça;2013;0;0,0;0;0,0;0;0,0
3529609;Meridiano;2013;0;0,0;0;0,0;0;0,0
3529658;Mesópolis;2013;0;0,0;0;0,0;0;0,0
3529807;Mineiros do Tietê;2013;0;0,0;0;0,0;0;0,0
3529906;Miracatu;2013;0;0,0;0;0,0;0;0,0
3530003;Mira Estrela;2013;0;0,0;0;0,0;0;0,0
3530201;Mirante do Paranapanema;2013;0;0,0;0;0,0;0;0,0
3530409;Mirassolândia;2013;0;0,0;0;0,0;0;0,0
3530904;Mombuca;2013;0;0,0;0;0,0;0;0,0
3531001;Monções;2013;0;0,0;0;0,0;0;0,0
3531209;Monte Alegre do Sul;2013;0;0,0;0;0,0;0;0,0
3531605;Monte Castelo;2013;0;0,0;0;0,0;0;0,0
3531704;Monteiro Lobato;2013;0;0,0;0;0,0;0;0,0
3532058;Motuca;2013;0;0,0;0;0,0;0;0,0
3532108;Murutinga do Sul;2013;0;0,0;0;0,0;0;0,0
3532157;Nantes;2013;0;0,0;0;0,0;0;0,0
3532207;Narandiba;2013;0;0,0;0;0,0;0;0,0
3532306;Natividade da Serra;2013;0;0,0;0;0,0;0;0,0
3532702;Nipoã;2013;0;0,0;0;0,0;0;0,0
3532801;Nova Aliança;2013;0;0,0;0;0,0;0;0,0
3532827;Nova Campina;2013;0;0,0;0;0,0;0;0,0
3532843;Nova Canaã Paulista;2013;0;0,0;0;0,0;0;0,0
3532868;Nova Castilho;2013;0;0,0;0;0,0;0;0,0
3533106;Nova Guataporanga;2013;0;0,0;0;0,0;0;0,0
3533205;Nova Independência;2013;0;0,0;0;0,0;0;0,0
3533254;Novais;2013;0;0,0;0;0,0;0;0,0
3533304;Nova Luzitânia;2013;0;0,0;0;0,0;0;0,0
3533601;Nuporanga;2013;0;0,0;0;0,0;0;0,0
3533700;Ocauçu;2013;0;0,0;0;0,0;0;0,0
3533809;Óleo;2013;0;0,0;0;0,0;0;0,0
3534005;Onda Verde;2013;0;0,0;0;0,0;0;0,0
3534104;Oriente;2013;0;0,0;0;0,0;0;0,0
3534203;Orindiúva;2013;0;0,0;0;0,0;0;0,0
3534500;Oscar Bressane;2013;0;0,0;0;0,0;0;0,0
3534807;Ouro Verde;2013;0;0,0;0;0,0;0;0,0
3535002;Palestina;2013;0;0,0;0;0,0;0;0,0
3535101;Palmares Paulista;2013;0;0,0;0;0,0;0;0,0
3535705;Paraíso;2013;0;0,0;0;0,0;0;0,0
3535903;Paranapuã;2013;0;0,0;0;0,0;0;0,0
3536109;Pardinho;2013;0;0,0;0;0,0;0;0,0
3536257;Parisi;2013;0;0,0;0;0,0;0;0,0
3536406;Paulicéia;2013;0;0,0;0;0,0;0;0,0
3536570;Paulistânia;2013;0;0,0;0;0,0;0;0,0
3536802;Pedra Bela;2013;0;0,0;0;0,0;0;0,0
3536901;Pedranópolis;2013;0;0,0;0;0,0;0;0,0
3537156;Pedrinhas Paulista;2013;0;0,0;0;0,0;0;0,0
3537206;Pedro de Toledo;2013;0;0,0;0;0,0;0;0,0
3537503;Pereiras;2013;0;0,0;0;0,0;0;0,0
3537701;Piacatu;2013;0;0,0;0;0,0;0;0,0
3538105;Pindorama;2013;0;0,0;0;0,0;0;0,0
3538204;Pinhalzinho;2013;0;0,0;0;0,0;0;0,0
3538303;Piquerobi;2013;0;0,0;0;0,0;0;0,0
3538501;Piquete;2013;0;0,0;0;0,0;0;0,0
3539103;Pirapora do Bom Jesus;2013;0;0,0;0;0,0;0;0,0
3539608;Planalto;2013;0;0,0;0;0,0;0;0,0
3539707;Platina;2013;0;0,0;0;0,0;0;0,0
3539905;Poloni;2013;0;0,0;0;0,0;0;0,0
3540101;Pongaí;2013;0;0,0;0;0,0;0;0,0
3540259;Pontalinda;2013;0;0,0;0;0,0;0;0,0
3540309;Pontes Gestal;2013;0;0,0;0;0,0;0;0,0
3540507;Porangaba;2013;0;0,0;0;0,0;0;0,0
3540754;Potim;2013;0;0,0;0;0,0;0;0,0
3540853;Pracinha;2013;0;0,0;0;0,0;0;0,0
3540903;Pradópolis;2013;0;0,0;0;0,0;0;0,0
3541059;Pratânia;2013;0;0,0;0;0,0;0;0,0
3541109;Presidente Alves;2013;0;0,0;0;0,0;0;0,0
3541653;Quadra;2013;0;0,0;0;0,0;0;0,0
3541703;Quatá;2013;0;0,0;0;0,0;0;0,0
3541802;Queiroz;2013;0;0,0;0;0,0;0;0,0
3542008;Quintana;2013;0;0,0;0;0,0;0;0,0
3542107;Rafard;2013;0;0,0;0;0,0;0;0,0
3542305;Redenção da Serra;2013;0;0,0;0;0,0;0;0,0
3542503;Reginópolis;2013;0;0,0;0;0,0;0;0,0
3542701;Restinga;2013;0;0,0;0;0,0;0;0,0
3542800;Ribeira;2013;0;0,0;0;0,0;0;0,0
3543105;Ribeirão Corrente;2013;0;0,0;0;0,0;0;0,0
3543204;Ribeirão do Sul;2013;0;0,0;0;0,0;0;0,0
3543238;Ribeirão dos Índios;2013;0;0,0;0;0,0;0;0,0
3543253;Ribeirão Grande;2013;0;0,0;0;0,0;0;0,0
3543501;Riversul;2013;0;0,0;0;0,0;0;0,0
3543600;Rifaina;2013;0;0,0;0;0,0;0;0,0
3543709;Rincão;2013;0;0,0;0;0,0;0;0,0
3544103;Rio Grande da Serra;2013;0;0,0;0;0,0;0;0,0
3544400;Rubiácea;2013;0;0,0;0;0,0;0;0,0
3544509;Rubinéia;2013;0;0,0;0;0,0;0;0,0
3544608;Sabino;2013;0;0,0;0;0,0;0;0,0
3544707;Sagres;2013;0;0,0;0;0,0;0;0,0
3544806;Sales;2013;0;0,0;0;0,0;0;0,0
3545100;Salmourão;2013;0;0,0;0;0,0;0;0,0
3545159;Saltinho;2013;0;0,0;0;0,0;0;0,0
3545506;Sandovalina;2013;0;0,0;0;0,0;0;0,0
3545704;Santa Albertina;2013;0;0,0;0;0,0;0;0,0
3546009;Santa Branca;2013;0;0,0;0;0,0;0;0,0
3546108;Santa Clara d'Oeste;2013;0;0,0;0;0,0;0;0,0
3546207;Santa Cruz da Conceição;2013;0;0,0;0;0,0;0;0,0
3546256;Santa Cruz da Esperança;2013;0;0,0;0;0,0;0;0,0
3546504;Santa Ernestina;2013;0;0,0;0;0,0;0;0,0
3546702;Santa Gertrudes;2013;0;0,0;0;0,0;0;0,0
3546900;Santa Lúcia;2013;0;0,0;0;0,0;0;0,0
3547106;Santa Mercedes;2013;0;0,0;0;0,0;0;0,0
3547205;Santana da Ponte Pensa;2013;0;0,0;0;0,0;0;0,0
3547403;Santa Rita d'Oeste;2013;0;0,0;0;0,0;0;0,0
3547650;Santa Salete;2013;0;0,0;0;0,0;0;0,0
3548005;Santo Antônio de Posse;2013;0;0,0;0;0,0;0;0,0
3548054;Santo Antônio do Aracanguá;2013;0;0,0;0;0,0;0;0,0
3548104;Santo Antônio do Jardim;2013;0;0,0;0;0,0;0;0,0
3548203;Santo Antônio do Pinhal;2013;0;0,0;0;0,0;0;0,0
3548302;Santo Expedito;2013;0;0,0;0;0,0;0;0,0
3548401;Santópolis do Aguapeí;2013;0;0,0;0;0,0;0;0,0
3549003;São Francisco;2013;0;0,0;0;0,0;0;0,0
3549201;São João das Duas Pontes;2013;0;0,0;0;0,0;0;0,0
3549250;São João de Iracema;2013;0;0,0;0;0,0;0;0,0
3549300;São João do Pau d'Alho;2013;0;0,0;0;0,0;0;0,0
3549508;São José da Bela Vista;2013;0;0,0;0;0,0;0;0,0
3549607;São José do Barreiro;2013;0;0,0;0;0,0;0;0,0
3549953;São Lourenço da Serra;2013;0;0,0;0;0,0;0;0,0
3550506;São Pedro do Turvo;2013;0;0,0;0;0,0;0;0,0
3551108;Sarapuí;2013;0;0,0;0;0,0;0;0,0
3551207;Sarutaiá;2013;0;0,0;0;0,0;0;0,0
3551306;Sebastianópolis do Sul;2013;0;0,0;0;0,0;0;0,0
3551405;Serra Azul;2013;0;0,0;0;0,0;0;0,0
3551801;Sete Barras;2013;0;0,0;0;0,0;0;0,0
3551900;Severínia;2013;0;0,0;0;0,0;0;0,0
3552551;Suzanápolis;2013;0;0,0;0;0,0;0;0,0
3552908;Taciba;2013;0;0,0;0;0,0;0;0,0
3553104;Taiaçu;2013;0;0,0;0;0,0;0;0,0
3553500;Tapiraí;2013;0;0,0;0;0,0;0;0,0
3553658;Taquaral;2013;0;0,0;0;0,0;0;0,0
3553856;Taquarivaí;2013;0;0,0;0;0,0;0;0,0
3553906;Tarabai;2013;0;0,0;0;0,0;0;0,0
3553955;Tarumã;2013;0;0,0;0;0,0;0;0,0
3554201;Tejupá;2013;0;0,0;0;0,0;0;0,0
3554607;Timburi;2013;0;0,0;0;0,0;0;0,0
3554656;Torre de Pedra;2013;0;0,0;0;0,0;0;0,0
3554755;Trabiju;2013;0;0,0;0;0,0;0;0,0
3554904;Três Fronteiras;2013;0;0,0;0;0,0;0;0,0
3554953;Tuiuti;2013;0;0,0;0;0,0;0;0,0
3555208;Turiúba;2013;0;0,0;0;0,0;0;0,0
3555307;Turmalina;2013;0;0,0;0;0,0;0;0,0
3555356;Ubarana;2013;0;0,0;0;0,0;0;0,0
3555505;Ubirajara;2013;0;0,0;0;0,0;0;0,0
3555604;Uchoa;2013;0;0,0;0;0,0;0;0,0
3555703;União Paulista;2013;0;0,0;0;0,0;0;0,0
3555901;Uru;2013;0;0,0;0;0,0;0;0,0
3556107;Valentim Gentil;2013;0;0,0;0;0,0;0;0,0
3556354;Vargem;2013;0;0,0;0;0,0;0;0,0
3556453;Vargem Grande Paulista;2013;0;0,0;0;0,0;0;0,0
3556602;Vera Cruz;2013;0;0,0;0;0,0;0;0,0
3556958;Vitória Brasil;2013;0;0,0;0;0,0;0;0,0
3557154;Zacarias;2013;0;0,0;0;0,0;0;0,0
3557303;Estiva Gerbi;2013;0;0,0;0;0,0;0;0,0
3500600;Águas de São Pedro;2013;4;1,4;4;1,4;0;0,0
3501707;Américo Brasiliense;2013;204;5,6;204;5,6;0;0,0
3503109;Arandu;2013;16;2,6;16;2,6;0;0,0
3504909;Bananal;2013;15;1,5;15;1,5;0;0,0
3505609;Barrinha;2013;29;1,0;29;1,0;0;0,0
3506359;Bertioga;2013;46;0,9;46;0,9;0;0,0
3506409;Bilac;2013;36;4,9;36;4,9;0;0,0
3507100;Bom Jesus dos Perdões;2013;11;0,5;11;0,5;0;0,0
3509254;Cajati;2013;13;0,5;13;0,5;0;0,0
3509601;Campo Limpo Paulista;2013;56;0,7;56;0,7;0;0,0
3512308;Conchas;2013;42;2,5;42;2,5;0;0,0
3513900;Divinolândia;2013;198;17,8;198;17,8;0;0,0
3514809;Eldorado;2013;2;0,1;2;0,1;0;0,0
3514908;Elias Fausto;2013;6;0,4;6;0,4;0;0,0
3515004;Embu das Artes;2013;71;0,3;71;0,3;0;0,0
3515103;Embu-Guaçu;2013;16;0,2;16;0,2;0;0,0
3515707;Ferraz de Vasconcelos;2013;193;1,1;193;1,1;0;0,0
3517604;Guapiara;2013;19;1,1;19;1,1;0;0,0
3519006;Herculândia;2013;32;3,6;32;3,6;0;0,0
3519303;Ibaté;2013;32;1,0;32;1,0;0;0,0
3519907;Iepê;2013;20;2,6;20;2,6;0;0,0
3520202;Igaratá;2013;15;1,7;15;1,7;0;0,0
3520301;Iguape;2013;13;0,4;13;0,4;0;0,0
3521002;Iperó;2013;15;0,5;15;0,5;0;0,0
3522109;Itanhaém;2013;74;0,8;74;0,8;0;0,0
3523107;Itaquaquecetuba;2013;224;0,7;224;0,7;0;0,0
3524204;Jaborandi;2013;17;2,6;17;2,6;0;0,0
3526100;Juquiá;2013;15;0,8;15;0,8;0;0,0
3528502;Mairiporã;2013;47;0,5;47;0,5;0;0,0
3528809;Maracaí;2013;26;1,9;26;1,9;0;0,0
3530102;Mirandópolis;2013;96;3,4;96;3,4;0;0,0
3531100;Mongaguá;2013;44;0,9;44;0,9;0;0,0
3532009;Morungaba;2013;13;1,1;13;1,1;0;0,0
3532405;Nazaré Paulista;2013;24;1,4;24;1,4;0;0,0
3533403;Nova Odessa;2013;53;1,0;53;1,0;0;0,0
3535804;Paranapanema;2013;30;1,6;30;1,6;0;0,0
3536208;Pariquera-Açu;2013;152;8,1;152;8,1;0;0,0
3536505;Paulínia;2013;84;0,9;84;0,9;0;0,0
3537602;Peruíbe;2013;39;0,6;39;0,6;0;0,0
3539202;Pirapozinho;2013;59;2,3;59;2,3;0;0,0
3539806;Poá;2013;21;0,2;21;0,2;0;0,0
3540002;Pompéia;2013;41;2,0;41;2,0;0;0,0
3541604;Promissão;2013;75;2,0;75;2,0;0;0,0
3541901;Queluz;2013;26;2,2;26;2,2;0;0,0
3544251;Rosana;2013;57;3,0;57;3,0;0;0,0
3544301;Roseira;2013;14;1,4;14;1,4;0;0,0
3547007;Santa Maria da Serra;2013;2;0,4;2;0,4;0;0,0
3547304;Santana de Parnaíba;2013;16;0,1;16;0,1;0;0,0
3547908;Santo Antônio da Alegria;2013;12;1,9;12;1,9;0;0,0
3550209;São Miguel Arcanjo;2013;46;1,5;46;1,5;0;0,0
3552007;Silveiras;2013;3;0,5;3;0,5;0;0,0
3552304;Sud Mennucci;2013;20;2,7;20;2,7;0;0,0
3553203;Taiúva;2013;4;0,6;4;0,6;0;0,0
3556503;Várzea Paulista;2013;27;0,2;27;0,2;0;0,0
3556909;Vista Alegre do Alto;2013;9;1,2;9;1,2;0;0,0
3507407;Borborema;2013;26;1,8;16;1,1;10;0,7
3510005;Cândido Mota;2013;50;1,7;40;1,3;10;0,3
3511508;Cerquilho;2013;43;1,0;33;0,8;10;0,2
3511904;Clementina;2013;30;4,0;20;2,7;10;1,3
3512100;Colômbia;2013;30;5,0;20;3,3;10;1,7
3537107;Pedreira;2013;98;2,3;88;2,0;10;0,2
3538907;Pirajuí;2013;299;13,0;289;12,6;10;0,4
3540408;Populina;2013;18;4,3;8;1,9;10;2,4
3541307;Presidente Epitácio;2013;78;1,9;68;1,6;10;0,2
3544905;Sales Oliveira;2013;29;2,7;19;1,7;10;0,9
3505807;Bastos;2013;35;1,7;28;1,4;7;0,3
3508603;Cachoeira Paulista;2013;47;1,5;40;1,3;7;0,2
3511706;Charqueada;2013;33;2,1;26;1,7;7;0,4
3512001;Colina;2013;47;2,7;40;2,3;7;0,4
3517802;Guaraçaí;2013;27;3,2;20;2,4;7;0,8
3518305;Guararema;2013;35;1,3;28;1,0;7;0,3
3523503;Itatinga;2013;14;0,7;7;0,4;7;0,4
3525508;Joanópolis;2013;24;2,0;17;1,4;7;0,6
3527306;Louveira;2013;41;1,0;34;0,8;7;0,2
3531803;Monte Mor;2013;36;0,7;29;0,6;7;0,1
3542404;Regente Feijó;2013;24;1,3;17;0,9;7;0,4
3550100;São Manuel;2013;43;1,1;36;0,9;7;0,2
3553005;Taguaí;2013;31;2,7;24;2,1;7;0,6
3554706;Torrinha;2013;20;2,1;13;1,4;7;0,7
3555406;Ubatuba;2013;76;0,9;69;0,8;7;0,1
3501004;Altinópolis;2013;31;2,0;25;1,6;6;0,4
3502705;Apiaí;2013;51;2,0;45;1,8;6;0,2
3507902;Brotas;2013;41;1,8;35;1,6;6;0,3
3508702;Caconde;2013;61;3,3;55;3,0;6;0,3
3509304;Cajobi;2013;32;3,2;26;2,6;6;0,6
3514304;Dourado;2013;18;2,1;12;1,4;6;0,7
3536000;Parapuã;2013;32;3,0;26;2,4;6;0,6
3542909;Ribeirão Bonito;2013;17;1,4;11;0,9;6;0,5
3553609;Tapiratiba;2013;24;1,9;18;1,4;6;0,5
3554300;Teodoro Sampaio;2013;58;2,7;52;2,4;6;0,3
3508405;Cabreúva;2013;36;0,8;28;0,6;8;0,2
3517703;Guará;2013;30;1,5;22;1,1;8;0,4
3520004;Igaraçu do Tietê;2013;63;2,7;55;2,3;8;0,3
3534906;Pacaembu;2013;37;2,8;29;2,2;8;0,6
3537909;Pilar do Sul;2013;35;1,3;27;1,0;8;0,3
3538600;Piracaia;2013;37;1,5;29;1,1;8;0,3
3543808;Rinópolis;2013;33;3,3;25;2,5;8;0,8
3550704;São Sebastião;2013;101;1,3;93;1,2;8;0,1
3550902;São Simão;2013;40;2,8;32;2,2;8;0,6
3552106;Socorro;2013;62;1,7;54;1,4;8;0,2
3514502;Duartina;2013;82;6,7;77;6,3;5;0,4
3532900;Nova Europa;2013;12;1,2;7;0,7;5;0,5
3501301;Álvares Machado;2013;20;0,8;18;0,8;2;0,1
3506706;Boa Esperança do Sul;2013;15;1,1;13;0,9;2;0,1
3513108;Cravinhos;2013;15;0,5;13;0,4;2;0,1
3519105;Iacanga;2013;27;2,6;25;2,4;2;0,2
3524709;Jaguariúna;2013;80;1,7;78;1,6;2;0,0
3535606;Paraibuna;2013;14;0,8;12;0,7;2;0,1
3555802;Urânia;2013;26;3,0;24;2,7;2;0,2
3527405;Lucélia;2013;67;3,3;48;2,4;19;0,9
3528106;Macaubal;2013;24;3,1;5;0,6;19;2,5
3529708;Miguelópolis;2013;66;3,2;47;2,3;19;0,9
3531506;Monte Azul Paulista;2013;70;3,7;51;2,7;19;1,0
3535507;Paraguaçu Paulista;2013;97;2,3;78;1,8;19;0,4
3547700;Santo Anastácio;2013;56;2,8;37;1,8;19;0,9
3552601;Tabapuã;2013;30;2,6;11;1,0;19;1,6
3556008;Urupês;2013;34;2,6;15;1,2;19;1,5
3509403;Cajuru;2013;68;2,8;50;2,1;18;0,7
3510203;Capão Bonito;2013;67;1,5;49;1,1;18;0,4
3517406;Guaíra;2013;60;1,6;42;1,1;18;0,5
3519402;Ibirá;2013;27;2,4;9;0,8;18;1,6
3520103;Igarapava;2013;50;1,8;32;1,1;18;0,6
3533908;Olímpia;2013;98;1,9;80;1,6;18;0,4
3539509;Pitangueiras;2013;50;1,4;32;0,9;18;0,5
3553807;Taquarituba;2013;54;2,4;36;1,6;18;0,8
3503802;Artur Nogueira;2013;12;0,3;0;0,0;12;0,3
3536307;Patrocínio Paulista;2013;35;2,6;23;1,7;12;0,9
3540606;Porto Feliz;2013;51;1,0;39;0,8;12;0,2
3545407;Salto Grande;2013;34;3,8;22;2,5;12;1,4
3546801;Santa Isabel;2013;104;2,0;92;1,8;12;0,2
3547601;Santa Rosa de Viterbo;2013;30;1,2;18;0,7;12;0,5
3502754;Araçariguama;2013;4;0,2;0;0,0;4;0,2
3511003;Castilho;2013;31;1,6;27;1,4;4;0,2
3513504;Cubatão;2013;138;1,1;134;1,1;4;0,0
3519204;Iacri;2013;19;3,0;15;2,4;4;0,6
3519709;Ibiúna;2013;67;0,9;63;0,9;4;0,1
3523602;Itirapina;2013;24;1,5;20;1,2;4;0,2
3539400;Piratininga;2013;30;2,4;26;2,1;4;0,3
3550803;São Sebastião da Grama;2013;30;2,5;26;2,2;4;0,3
3552403;Sumaré;2013;184;0,7;180;0,7;4;0,0
3501103;Alto Alegre;2013;22;5,4;19;4,7;3;0,7
3502200;Angatuba;2013;57;2,5;54;2,4;3;0,1
3520400;Ilhabela;2013;40;1,3;37;1,2;3;0,1
3540804;Potirendaba;2013;31;2,0;28;1,8;3;0,2
3545001;Salesópolis;2013;24;1,5;21;1,3;3;0,2
3503406;Arealva;2013;28;3,5;17;2,1;11;1,4
3508801;Cafelândia;2013;58;3,5;47;2,8;11;0,7
3512209;Conchal;2013;52;2,0;41;1,6;11;0,4
3522901;Itapuí;2013;33;2,6;22;1,7;11;0,9
3541208;Presidente Bernardes;2013;51;3,7;40;2,9;11;0,8
3510708;Cardoso;2013;31;2,6;18;1,5;13;1,1
3511607;Cesário Lange;2013;30;1,9;17;1,1;13;0,8
3528007;Macatuba;2013;31;1,9;18;1,1;13;0,8
3551603;Serra Negra;2013;55;2,1;42;1,6;13;0,5
3552700;Tabatinga;2013;35;2,3;22;1,5;13;0,9
3503703;Ariranha;2013;25;2,8;4;0,5;21;2,4
3516606;Gália;2013;45;6,6;24;3,5;21;3,1
3516903;General Salgado;2013;32;3,0;11;1,0;21;2,0
3525201;Jarinu;2013;33;1,3;12;0,5;21;0,8
3546306;Santa Cruz das Palmeiras;2013;46;1,5;25;0,8;21;0,7
3557204;Chavantes;2013;48;4,0;27;2,2;21;1,7
3511409;Cerqueira César;2013;42;2,3;33;1,8;9;0,5
3515400;Fartura;2013;26;1,7;17;1,1;9;0,6
3517000;Getulina;2013;51;4,7;42;3,9;9;0,8
3521309;Ipuã;2013;49;3,3;40;2,7;9;0,6
3526209;Juquitiba;2013;9;0,3;0;0,0;9;0,3
3538808;Piraju;2013;80;2,8;71;2,5;9;0,3
3553302;Tambaú;2013;34;1,5;25;1,1;9;0,4
3508108;Buritama;2013;42;2,7;22;1,4;20;1,3
3514106;Dois Córregos;2013;67;2,6;47;1,8;20;0,8
3520905;Ipaussu;2013;49;3,5;29;2,1;20;1,4
3535408;Panorama;2013;65;4,4;45;3,0;20;1,4
3536703;Pederneiras;2013;72;1,7;52;1,2;20;0,5
3537008;Pedregulho;2013;53;3,3;33;2,1;20;1,3
3545605;Santa Adélia;2013;31;2,1;11;0,8;20;1,4
3513603;Cunha;2013;40;1,8;25;1,1;15;0,7
3513702;Descalvado;2013;38;1,2;23;0,7;15;0,5
3536604;Paulo de Faria;2013;24;2,8;9;1,1;15;1,8
3544004;Rio das Pedras;2013;53;1,7;38;1,2;15;0,5
3550001;São Luiz do Paraitinga;2013;26;2,5;11;1,1;15;1,4
3551504;Serrana;2013;58;1,4;43;1,1;15;0,4
3500105;Adamantina;2013;284;8,4;240;7,1;44;1,3
3500709;Agudos;2013;65;1,9;43;1,2;22;0,6
3501608;Americana;2013;683;3,1;340;1,6;343;1,6
3501905;Amparo;2013;349;5,2;236;3,5;113;1,7
3502101;Andradina;2013;135;2,4;110;2,0;25;0,4
3502507;Aparecida;2013;84;2,4;50;1,4;34;1,0
3502606;Aparecida d'Oeste;2013;30;6,9;8;1,8;22;5,1
3502804;Araçatuba;2013;625;3,4;477;2,6;148;0,8
3502903;Araçoiaba da Serra;2013;90;3,1;0;0,0;90;3,1
3503208;Araraquara;2013;586;2,7;268;1,2;318;1,5
3503307;Araras;2013;557;4,5;289;2,4;268;2,2
3503901;Arujá;2013;82;1,0;15;0,2;67;0,8
3504008;Assis;2013;311;3,2;199;2,1;112;1,2
3504107;Atibaia;2013;187;1,4;50;0,4;137;1,0
3504503;Avaré;2013;153;1,8;95;1,1;58;0,7
3505203;Bariri;2013;68;2,1;52;1,6;16;0,5
3505302;Barra Bonita;2013;101;2,9;68;1,9;33;0,9
3505500;Barretos;2013;642;5,6;527;4,6;115;1,0
3505708;Barueri;2013;477;1,9;381;1,5;96;0,4
3505906;Batatais;2013;139;2,4;94;1,6;45;0,8
3506003;Bauru;2013;1.144;3,3;697;2,0;447;1,3
3506102;Bebedouro;2013;157;2,1;111;1,5;46;0,6
3506300;Bernardino de Campos;2013;50;4,6;20;1,9;30;2,8
3506508;Birigui;2013;242;2,1;155;1,4;87;0,8
3507001;Boituva;2013;55;1,1;39;0,8;16;0,3
3507506;Botucatu;2013;604;4,6;497;3,8;107;0,8
3507605;Bragança Paulista;2013;343;2,3;215;1,4;128;0,8
3508504;Caçapava;2013;147;1,7;74;0,9;73;0,8
3509007;Caieiras;2013;68;0,7;29;0,3;39;0,4
3509205;Cajamar;2013;171;2,5;71;1,0;100;1,5
3509502;Campinas;2013;2.961;2,7;1.425;1,3;1.536;1,4
3509700;Campos do Jordão;2013;376;7,8;329;6,8;47;1,0
3510401;Capivari;2013;96;1,9;41;0,8;55;1,1
3510500;Caraguatatuba;2013;158;1,5;120;1,1;38;0,4
3510609;Carapicuíba;2013;353;0,9;263;0,7;90;0,2
3510807;Casa Branca;2013;412;14,4;395;13,8;17;0,6
3511102;Catanduva;2013;513;4,5;373;3,3;140;1,2
3512803;Cosmópolis;2013;103;1,6;74;1,2;29;0,5
3513009;Cotia;2013;287;1,3;189;0,9;98;0,5
3513405;Cruzeiro;2013;156;2,0;111;1,4;45;0,6
3513801;Diadema;2013;720;1,8;574;1,5;146;0,4
3514403;Dracena;2013;143;3,3;108;2,5;35;0,8
3515186;Espírito Santo do Pinhal;2013;458;10,9;369;8,8;89;2,1
3515509;Fernandópolis;2013;172;2,6;92;1,4;80;1,2
3516200;Franca;2013;720;2,2;456;1,4;264;0,8
3516309;Francisco Morato;2013;144;0,9;95;0,6;49;0,3
3516408;Franco da Rocha;2013;654;4,7;424;3,1;230;1,7
3516705;Garça;2013;376;8,8;331;7,7;45;1,0
3518404;Guaratinguetá;2013;303;2,7;210;1,8;93;0,8
3518602;Guariba;2013;72;2,0;50;1,4;22;0,6
3518701;Guarujá;2013;305;1,0;237;0,8;68;0,2
3518800;Guarulhos;2013;1.928;1,5;1.441;1,1;487;0,4
3519071;Hortolândia;2013;91;0,4;62;0,3;29;0,1
3519600;Ibitinga;2013;99;1,8;52;0,9;47;0,9
3520442;Ilha Solteira;2013;116;4,6;74;2,9;42;1,7
3520509;Indaiatuba;2013;367;1,7;258;1,2;109;0,5
3520707;Indiaporã;2013;40;10,3;5;1,3;35;9,0
3521804;Itaí;2013;41;1,7;40;1,6;1;0,0
3521903;Itajobi;2013;30;2,1;13;0,9;17;1,2
3522208;Itapecerica da Serra;2013;446;2,8;281;1,8;165;1,0
3522307;Itapetininga;2013;129;0,9;107;0,7;22;0,1
3522406;Itapeva;2013;192;2,2;150;1,7;42;0,5
3522505;Itapevi;2013;254;1,2;205;1,0;49;0,2
3522604;Itapira;2013;1.377;19,8;838;12,0;539;7,7
3522703;Itápolis;2013;76;1,9;45;1,1;31;0,8
3522802;Itaporanga;2013;49;3,4;33;2,3;16;1,1
3523206;Itararé;2013;98;2,0;82;1,7;16;0,3
3523404;Itatiba;2013;112;1,1;60;0,6;52;0,5
3523909;Itu;2013;426;2,7;391;2,5;35;0,2
3524006;Itupeva;2013;86;1,8;48;1,0;38;0,8
3524105;Ituverava;2013;120;3,1;58;1,5;62;1,6
3524303;Jaboticabal;2013;136;1,9;71;1,0;65;0,9
3524402;Jacareí;2013;421;1,9;211;1,0;210;1,0
3524501;Jaci;2013;177;29,2;135;22,3;42;6,9
3524808;Jales;2013;165;3,5;70;1,5;95;2,0
3525003;Jandira;2013;58;0,5;44;0,4;14;0,1
3525300;Jaú;2013;860;6,3;705;5,2;155;1,1
3525706;José Bonifácio;2013;61;1,8;34;1,0;27;0,8
3525904;Jundiaí;2013;664;1,7;308;0,8;356;0,9
3526001;Junqueirópolis;2013;52;2,7;26;1,4;26;1,4
3526407;Laranjal Paulista;2013;75;2,9;58;2,2;17;0,7
3526704;Leme;2013;127;1,3;76;0,8;51;0,5
3526803;Lençóis Paulista;2013;80;1,3;57;0,9;23;0,4
3526902;Limeira;2013;431;1,5;234;0,8;197;0,7
3527108;Lins;2013;446;6,1;349;4,8;97;1,3
3527207;Lorena;2013;173;2,1;105;1,3;68;0,8
3527702;Luiziânia;2013;32;6,1;15;2,9;17;3,2
3529005;Marília;2013;895;4,0;750;3,4;145;0,7
3529203;Martinópolis;2013;66;2,7;41;1,7;25;1,0
3529302;Matão;2013;164;2,1;96;1,2;68;0,9
3529401;Mauá;2013;576;1,3;292;0,7;284;0,7
3530300;Mirassol;2013;93;1,7;29;0,5;64;1,2
3530508;Mococa;2013;135;2,0;86;1,3;49;0,7
3530607;Mogi das Cruzes;2013;736;1,8;561;1,4;175;0,4
3530706;Mogi Guaçu;2013;328;2,3;149;1,1;179;1,3
3530805;Mogi Mirim;2013;268;3,1;140;1,6;128;1,5
3531308;Monte Alto;2013;109;2,3;58;1,2;51;1,1
3531407;Monte Aprazível;2013;80;3,6;35;1,6;45;2,0
3531902;Morro Agudo;2013;45;1,5;31;1,0;14;0,5
3532504;Neves Paulista;2013;35;4,0;11;1,3;24;2,7
3532603;Nhandeara;2013;129;12,0;36;3,3;93;8,6
3533007;Nova Granada;2013;193;9,8;42;2,1;151;7,7
3533502;Novo Horizonte;2013;105;2,8;38;1,0;67;1,8
3534302;Orlândia;2013;98;2,4;59;1,5;39;1,0
3534401;Osasco;2013;1.009;1,5;593;0,9;416;0,6
3534609;Osvaldo Cruz;2013;90;2,9;59;1,9;31;1,0
3534708;Ourinhos;2013;315;3,0;230;2,2;85;0,8
3534757;Ouroeste;2013;39;4,4;10;1,1;29;3,3
3535200;Palmeira d'Oeste;2013;24;2,5;10;1,1;14;1,5
3535309;Palmital;2013;68;3,2;44;2,1;24;1,1
3537305;Penápolis;2013;238;4,0;168;2,8;70;1,2
3537404;Pereira Barreto;2013;98;3,9;65;2,6;33;1,3
3537800;Piedade;2013;521;9,9;471;9,0;50;1,0
3538006;Pindamonhangaba;2013;210;1,4;134;0,9;76;0,5
3538709;Piracicaba;2013;815;2,2;312;0,8;503;1,4
3539004;Pirangi;2013;37;3,5;9;0,8;28;2,6
3539301;Pirassununga;2013;87;1,2;52;0,7;35;0,5
3540200;Pontal;2013;75;1,7;45;1,0;30;0,7
3540705;Porto Ferreira;2013;61;1,2;37;0,7;24;0,5
3541000;Praia Grande;2013;199;0,7;113;0,4;86;0,3
3541406;Presidente Prudente;2013;1.570;7,4;1.094;5,2;476;2,2
3541505;Presidente Venceslau;2013;97;2,6;75;2,0;22;0,6
3542206;Rancharia;2013;98;3,4;70;2,4;28;1,0
3542602;Registro;2013;105;1,9;63;1,2;42;0,8
3543006;Ribeirão Branco;2013;36;2,0;35;1,9;1;0,1
3543303;Ribeirão Pires;2013;164;1,4;50;0,4;114;1,0
3543402;Ribeirão Preto;2013;1.980;3,1;1.369;2,2;611;1,0
3543907;Rio Claro;2013;478;2,5;274;1,4;204;1,1
3544202;Riolândia;2013;36;3,3;7;0,6;29;2,7
3545209;Salto;2013;123;1,1;70;0,6;53;0,5
3545308;Salto de Pirapora;2013;1.018;24,6;992;24,0;26;0,6
3545803;Santa Bárbara d'Oeste;2013;166;0,9;133;0,7;33;0,2
3546405;Santa Cruz do Rio Pardo;2013;108;2,4;65;1,5;43;1,0
3546603;Santa Fé do Sul;2013;76;2,6;33;1,1;43;1,4
3547502;Santa Rita do Passa Quatro;2013;299;11,3;271;10,2;28;1,1
3547809;Santo André;2013;1.476;2,2;684;1,0;792;1,2
3548500;Santos;2013;1.613;3,8;767;1,8;846;2,0
3548609;São Bento do Sapucaí;2013;40;3,8;26;2,5;14;1,3
3548708;São Bernardo do Campo;2013;1.596;2,0;729;0,9;867;1,1
3548807;São Caetano do Sul;2013;565;3,8;187;1,2;378;2,5
3548906;São Carlos;2013;419;1,8;204;0,9;215;0,9
3549102;São João da Boa Vista;2013;198;2,3;94;1,1;104;1,2
3549409;São Joaquim da Barra;2013;115;2,4;68;1,4;47;1,0
3549706;São José do Rio Pardo;2013;145;2,8;89;1,7;56;1,1
3549805;São José do Rio Preto;2013;1.726;4,1;992;2,4;734;1,7
3549904;São José dos Campos;2013;1.505;2,3;833;1,3;672;1,0
3550308;São Paulo;2013;28.700;2,5;15.195;1,3;13.505;1,2
3550407;São Pedro;2013;62;1,9;37;1,1;25;0,8
3550605;São Roque;2013;103;1,3;54;0,7;49;0,6
3551009;São Vicente;2013;331;1,0;276;0,8;55;0,2
3551702;Sertãozinho;2013;155;1,4;75;0,7;80;0,7
3552205;Sorocaba;2013;2.431;4,0;1.896;3,1;535;0,9
3552502;Suzano;2013;170;0,6;79;0,3;91;0,3
3552809;Taboão da Serra;2013;563;2,2;332;1,3;231;0,9
3553401;Tanabi;2013;72;2,9;38;1,6;34;1,4
3553708;Taquaritinga;2013;120;2,2;73;1,3;47;0,9
3554003;Tatuí;2013;208;1,9;93;0,8;115;1,0
3554102;Taubaté;2013;452;1,6;325;1,1;127;0,4
3554508;Tietê;2013;68;1,8;41;1,1;27;0,7
3554805;Tremembé;2013;30;0,7;0;0,0;30;0,7
3555000;Tupã;2013;864;13,7;791;12,5;73;1,2
3556206;Valinhos;2013;169;1,5;63;0,6;106;0,9
3556305;Valparaíso;2013;55;2,4;31;1,3;24;1,0
3556404;Vargem Grande do Sul;2013;77;1,9;47;1,2;30;0,8
3556701;Vinhedo;2013;95;1,4;0;0,0;95;1,4
3557006;Votorantim;2013;146;1,3;84;0,7;62;0,6
3557105;Votuporanga;2013;240;2,8;118;1,4;122;1,4
3500501;Águas de Lindóia;2013;42;2,4;30;1,7;12;0,7
3504206;Auriflama;2013;51;3,6;30;2,1;21;1,5
3506805;Bocaina;2013;35;3,1;30;2,7;5;0,4
3515202;Estrela d'Oeste;2013;50;6,1;30;3,7;20;2,4
3516002;Flórida Paulista;2013;47;3,7;30;2,4;17;1,3
3518206;Guararapes;2013;74;2,4;30;1,0;44;1,4
3521705;Itaberá;2013;35;2,0;30;1,7;5;0,3
3554409;Terra Roxa;2013;34;3,9;30;3,5;4;0,5
3555109;Tupi Paulista;2013;48;3,3;30;2,1;18;1,2
3556800;Viradouro;2013;48;2,7;30;1,7;18;1,0
3500204;Adolfo;2012;0;0,0;0;0,0;0;0,0
3500402;Águas da Prata;2012;0;0,0;0;0,0;0;0,0
3500550;Águas de Santa Bárbara;2012;0;0,0;0;0,0;0;0,0
3500758;Alambari;2012;0;0,0;0;0,0;0;0,0
3500808;Alfredo Marcondes;2012;0;0,0;0;0,0;0;0,0
3500907;Altair;2012;0;0,0;0;0,0;0;0,0
3501152;Alumínio;2012;0;0,0;0;0,0;0;0,0
3501202;Álvares Florence;2012;0;0,0;0;0,0;0;0,0
3501400;Álvaro de Carvalho;2012;0;0,0;0;0,0;0;0,0
3501509;Alvinlândia;2012;0;0,0;0;0,0;0;0,0
3501806;Américo de Campos;2012;0;0,0;0;0,0;0;0,0
3502002;Analândia;2012;0;0,0;0;0,0;0;0,0
3502309;Anhembi;2012;0;0,0;0;0,0;0;0,0
3502408;Anhumas;2012;0;0,0;0;0,0;0;0,0
3503000;Aramina;2012;0;0,0;0;0,0;0;0,0
3503158;Arapeí;2012;0;0,0;0;0,0;0;0,0
3503356;Arco-Íris;2012;0;0,0;0;0,0;0;0,0
3503505;Areias;2012;0;0,0;0;0,0;0;0,0
3503604;Areiópolis;2012;0;0,0;0;0,0;0;0,0
3503950;Aspásia;2012;0;0,0;0;0,0;0;0,0
3504305;Avaí;2012;0;0,0;0;0,0;0;0,0
3504404;Avanhandava;2012;0;0,0;0;0,0;0;0,0
3504602;Bady Bassitt;2012;0;0,0;0;0,0;0;0,0
3504701;Balbinos;2012;0;0,0;0;0,0;0;0,0
3504800;Bálsamo;2012;0;0,0;0;0,0;0;0,0
3505005;Barão de Antonina;2012;0;0,0;0;0,0;0;0,0
3505104;Barbosa;2012;0;0,0;0;0,0;0;0,0
3505351;Barra do Chapéu;2012;0;0,0;0;0,0;0;0,0
3505401;Barra do Turvo;2012;0;0,0;0;0,0;0;0,0
3506201;Bento de Abreu;2012;0;0,0;0;0,0;0;0,0
3506607;Biritiba Mirim;2012;0;0,0;0;0,0;0;0,0
3506904;Bofete;2012;0;0,0;0;0,0;0;0,0
3507159;Bom Sucesso de Itararé;2012;0;0,0;0;0,0;0;0,0
3507209;Borá;2012;0;0,0;0;0,0;0;0,0
3507308;Boracéia;2012;0;0,0;0;0,0;0;0,0
3507456;Borebi;2012;0;0,0;0;0,0;0;0,0
3507704;Braúna;2012;0;0,0;0;0,0;0;0,0
3507753;Brejo Alegre;2012;0;0,0;0;0,0;0;0,0
3507803;Brodowski;2012;0;0,0;0;0,0;0;0,0
3508009;Buri;2012;0;0,0;0;0,0;0;0,0
3508207;Buritizal;2012;0;0,0;0;0,0;0;0,0
3508306;Cabrália Paulista;2012;0;0,0;0;0,0;0;0,0
3508900;Caiabu;2012;0;0,0;0;0,0;0;0,0
3509106;Caiuá;2012;0;0,0;0;0,0;0;0,0
3509452;Campina do Monte Alegre;2012;0;0,0;0;0,0;0;0,0
3509809;Campos Novos Paulista;2012;0;0,0;0;0,0;0;0,0
3509908;Cananéia;2012;0;0,0;0;0,0;0;0,0
3509957;Canas;2012;0;0,0;0;0,0;0;0,0
3510104;Cândido Rodrigues;2012;0;0,0;0;0,0;0;0,0
3510153;Canitar;2012;0;0,0;0;0,0;0;0,0
3510302;Capela do Alto;2012;0;0,0;0;0,0;0;0,0
3510906;Cássia dos Coqueiros;2012;0;0,0;0;0,0;0;0,0
3511201;Catiguá;2012;0;0,0;0;0,0;0;0,0
3511300;Cedral;2012;0;0,0;0;0,0;0;0,0
3512407;Cordeirópolis;2012;0;0,0;0;0,0;0;0,0
3512506;Coroados;2012;0;0,0;0;0,0;0;0,0
3512605;Coronel Macedo;2012;0;0,0;0;0,0;0;0,0
3512704;Corumbataí;2012;0;0,0;0;0,0;0;0,0
3512902;Cosmorama;2012;0;0,0;0;0,0;0;0,0
3513207;Cristais Paulista;2012;0;0,0;0;0,0;0;0,0
3513306;Cruzália;2012;0;0,0;0;0,0;0;0,0
3513850;Dirce Reis;2012;0;0,0;0;0,0;0;0,0
3514007;Dobrada;2012;0;0,0;0;0,0;0;0,0
3514205;Dolcinópolis;2012;0;0,0;0;0,0;0;0,0
3514601;Dumont;2012;0;0,0;0;0,0;0;0,0
3514700;Echaporã;2012;0;0,0;0;0,0;0;0,0
3514924;Elisiário;2012;0;0,0;0;0,0;0;0,0
3514957;Embaúba;2012;0;0,0;0;0,0;0;0,0
3515129;Emilianópolis;2012;0;0,0;0;0,0;0;0,0
3515152;Engenheiro Coelho;2012;0;0,0;0;0,0;0;0,0
3515194;Espírito Santo do Turvo;2012;0;0,0;0;0,0;0;0,0
3515301;Estrela do Norte;2012;0;0,0;0;0,0;0;0,0
3515350;Euclides da Cunha Paulista;2012;0;0,0;0;0,0;0;0,0
3515608;Fernando Prestes;2012;0;0,0;0;0,0;0;0,0
3515657;Fernão;2012;0;0,0;0;0,0;0;0,0
3515806;Flora Rica;2012;0;0,0;0;0,0;0;0,0
3515905;Floreal;2012;0;0,0;0;0,0;0;0,0
3516101;Florínea;2012;0;0,0;0;0,0;0;0,0
3516507;Gabriel Monteiro;2012;0;0,0;0;0,0;0;0,0
3516804;Gastão Vidigal;2012;0;0,0;0;0,0;0;0,0
3516853;Gavião Peixoto;2012;0;0,0;0;0,0;0;0,0
3517109;Glicério;2012;0;0,0;0;0,0;0;0,0
3517208;Guaiçara;2012;0;0,0;0;0,0;0;0,0
3517307;Guaimbê;2012;0;0,0;0;0,0;0;0,0
3517505;Guapiaçu;2012;0;0,0;0;0,0;0;0,0
3517901;Guaraci;2012;0;0,0;0;0,0;0;0,0
3518008;Guarani d'Oeste;2012;0;0,0;0;0,0;0;0,0
3518107;Guarantã;2012;0;0,0;0;0,0;0;0,0
3518503;Guareí;2012;0;0,0;0;0,0;0;0,0
3518859;Guatapará;2012;0;0,0;0;0,0;0;0,0
3518909;Guzolândia;2012;0;0,0;0;0,0;0;0,0
3519055;Holambra;2012;0;0,0;0;0,0;0;0,0
3519253;Iaras;2012;0;0,0;0;0,0;0;0,0
3519501;Ibirarema;2012;0;0,0;0;0,0;0;0,0
3519808;Icém;2012;0;0,0;0;0,0;0;0,0
3520426;Ilha Comprida;2012;0;0,0;0;0,0;0;0,0
3520608;Indiana;2012;0;0,0;0;0,0;0;0,0
3520806;Inúbia Paulista;2012;0;0,0;0;0,0;0;0,0
3521101;Ipeúna;2012;0;0,0;0;0,0;0;0,0
3521150;Ipiguá;2012;0;0,0;0;0,0;0;0,0
3521200;Iporanga;2012;0;0,0;0;0,0;0;0,0
3521408;Iracemápolis;2012;0;0,0;0;0,0;0;0,0
3521507;Irapuã;2012;0;0,0;0;0,0;0;0,0
3521606;Irapuru;2012;0;0,0;0;0,0;0;0,0
3522000;Itaju;2012;0;0,0;0;0,0;0;0,0
3522158;Itaoca;2012;0;0,0;0;0,0;0;0,0
3522653;Itapirapuã Paulista;2012;0;0,0;0;0,0;0;0,0
3523008;Itapura;2012;0;0,0;0;0,0;0;0,0
3523305;Itariri;2012;0;0,0;0;0,0;0;0,0
3523701;Itirapuã;2012;0;0,0;0;0,0;0;0,0
3523800;Itobi;2012;0;0,0;0;0,0;0;0,0
3524600;Jacupiranga;2012;0;0,0;0;0,0;0;0,0
3524907;Jambeiro;2012;0;0,0;0;0,0;0;0,0
3525102;Jardinópolis;2012;0;0,0;0;0,0;0;0,0
3525409;Jeriquara;2012;0;0,0;0;0,0;0;0,0
3525607;João Ramalho;2012;0;0,0;0;0,0;0;0,0
3525805;Júlio Mesquita;2012;0;0,0;0;0,0;0;0,0
3525854;Jumirim;2012;0;0,0;0;0,0;0;0,0
3526308;Lagoinha;2012;0;0,0;0;0,0;0;0,0
3526506;Lavínia;2012;0;0,0;0;0,0;0;0,0
3526605;Lavrinhas;2012;0;0,0;0;0,0;0;0,0
3527009;Lindóia;2012;0;0,0;0;0,0;0;0,0
3527256;Lourdes;2012;0;0,0;0;0,0;0;0,0
3527504;Lucianópolis;2012;0;0,0;0;0,0;0;0,0
3527603;Luís Antônio;2012;0;0,0;0;0,0;0;0,0
3527801;Lupércio;2012;0;0,0;0;0,0;0;0,0
3527900;Lutécia;2012;0;0,0;0;0,0;0;0,0
3528205;Macedônia;2012;0;0,0;0;0,0;0;0,0
3528304;Magda;2012;0;0,0;0;0,0;0;0,0
3528403;Mairinque;2012;0;0,0;0;0,0;0;0,0
3528601;Manduri;2012;0;0,0;0;0,0;0;0,0
3528700;Marabá Paulista;2012;0;0,0;0;0,0;0;0,0
3528858;Marapoama;2012;0;0,0;0;0,0;0;0,0
3528908;Mariápolis;2012;0;0,0;0;0,0;0;0,0
3529104;Marinópolis;2012;0;0,0;0;0,0;0;0,0
3529500;Mendonça;2012;0;0,0;0;0,0;0;0,0
3529609;Meridiano;2012;0;0,0;0;0,0;0;0,0
3529658;Mesópolis;2012;0;0,0;0;0,0;0;0,0
3529807;Mineiros do Tietê;2012;0;0,0;0;0,0;0;0,0
3530003;Mira Estrela;2012;0;0,0;0;0,0;0;0,0
3530201;Mirante do Paranapanema;2012;0;0,0;0;0,0;0;0,0
3530409;Mirassolândia;2012;0;0,0;0;0,0;0;0,0
3530904;Mombuca;2012;0;0,0;0;0,0;0;0,0
3531001;Monções;2012;0;0,0;0;0,0;0;0,0
3531209;Monte Alegre do Sul;2012;0;0,0;0;0,0;0;0,0
3531605;Monte Castelo;2012;0;0,0;0;0,0;0;0,0
3531704;Monteiro Lobato;2012;0;0,0;0;0,0;0;0,0
3532058;Motuca;2012;0;0,0;0;0,0;0;0,0
3532157;Nantes;2012;0;0,0;0;0,0;0;0,0
3532207;Narandiba;2012;0;0,0;0;0,0;0;0,0
3532306;Natividade da Serra;2012;0;0,0;0;0,0;0;0,0
3532702;Nipoã;2012;0;0,0;0;0,0;0;0,0
3532801;Nova Aliança;2012;0;0,0;0;0,0;0;0,0
3532827;Nova Campina;2012;0;0,0;0;0,0;0;0,0
3532843;Nova Canaã Paulista;2012;0;0,0;0;0,0;0;0,0
3532868;Nova Castilho;2012;0;0,0;0;0,0;0;0,0
3533106;Nova Guataporanga;2012;0;0,0;0;0,0;0;0,0
3533205;Nova Independência;2012;0;0,0;0;0,0;0;0,0
3533254;Novais;2012;0;0,0;0;0,0;0;0,0
3533304;Nova Luzitânia;2012;0;0,0;0;0,0;0;0,0
3533601;Nuporanga;2012;0;0,0;0;0,0;0;0,0
3533700;Ocauçu;2012;0;0,0;0;0,0;0;0,0
3533809;Óleo;2012;0;0,0;0;0,0;0;0,0
3534005;Onda Verde;2012;0;0,0;0;0,0;0;0,0
3534104;Oriente;2012;0;0,0;0;0,0;0;0,0
3534203;Orindiúva;2012;0;0,0;0;0,0;0;0,0
3534500;Oscar Bressane;2012;0;0,0;0;0,0;0;0,0
3534807;Ouro Verde;2012;0;0,0;0;0,0;0;0,0
3535002;Palestina;2012;0;0,0;0;0,0;0;0,0
3535101;Palmares Paulista;2012;0;0,0;0;0,0;0;0,0
3535705;Paraíso;2012;0;0,0;0;0,0;0;0,0
3535903;Paranapuã;2012;0;0,0;0;0,0;0;0,0
3536109;Pardinho;2012;0;0,0;0;0,0;0;0,0
3536257;Parisi;2012;0;0,0;0;0,0;0;0,0
3536406;Paulicéia;2012;0;0,0;0;0,0;0;0,0
3536570;Paulistânia;2012;0;0,0;0;0,0;0;0,0
3536802;Pedra Bela;2012;0;0,0;0;0,0;0;0,0
3536901;Pedranópolis;2012;0;0,0;0;0,0;0;0,0
3537156;Pedrinhas Paulista;2012;0;0,0;0;0,0;0;0,0
3537206;Pedro de Toledo;2012;0;0,0;0;0,0;0;0,0
3537503;Pereiras;2012;0;0,0;0;0,0;0;0,0
3537701;Piacatu;2012;0;0,0;0;0,0;0;0,0
3538105;Pindorama;2012;0;0,0;0;0,0;0;0,0
3538204;Pinhalzinho;2012;0;0,0;0;0,0;0;0,0
3538303;Piquerobi;2012;0;0,0;0;0,0;0;0,0
3538501;Piquete;2012;0;0,0;0;0,0;0;0,0
3539103;Pirapora do Bom Jesus;2012;0;0,0;0;0,0;0;0,0
3539608;Planalto;2012;0;0,0;0;0,0;0;0,0
3539707;Platina;2012;0;0,0;0;0,0;0;0,0
3539905;Poloni;2012;0;0,0;0;0,0;0;0,0
3540101;Pongaí;2012;0;0,0;0;0,0;0;0,0
3540259;Pontalinda;2012;0;0,0;0;0,0;0;0,0
3540309;Pontes Gestal;2012;0;0,0;0;0,0;0;0,0
3540507;Porangaba;2012;0;0,0;0;0,0;0;0,0
3540754;Potim;2012;0;0,0;0;0,0;0;0,0
3540853;Pracinha;2012;0;0,0;0;0,0;0;0,0
3540903;Pradópolis;2012;0;0,0;0;0,0;0;0,0
3541059;Pratânia;2012;0;0,0;0;0,0;0;0,0
3541109;Presidente Alves;2012;0;0,0;0;0,0;0;0,0
3541653;Quadra;2012;0;0,0;0;0,0;0;0,0
3541703;Quatá;2012;0;0,0;0;0,0;0;0,0
3541802;Queiroz;2012;0;0,0;0;0,0;0;0,0
3542008;Quintana;2012;0;0,0;0;0,0;0;0,0
3542107;Rafard;2012;0;0,0;0;0,0;0;0,0
3542305;Redenção da Serra;2012;0;0,0;0;0,0;0;0,0
3542503;Reginópolis;2012;0;0,0;0;0,0;0;0,0
3542701;Restinga;2012;0;0,0;0;0,0;0;0,0
3542800;Ribeira;2012;0;0,0;0;0,0;0;0,0
3543105;Ribeirão Corrente;2012;0;0,0;0;0,0;0;0,0
3543204;Ribeirão do Sul;2012;0;0,0;0;0,0;0;0,0
3543238;Ribeirão dos Índios;2012;0;0,0;0;0,0;0;0,0
3543253;Ribeirão Grande;2012;0;0,0;0;0,0;0;0,0
3543501;Riversul;2012;0;0,0;0;0,0;0;0,0
3543600;Rifaina;2012;0;0,0;0;0,0;0;0,0
3543709;Rincão;2012;0;0,0;0;0,0;0;0,0
3544103;Rio Grande da Serra;2012;0;0,0;0;0,0;0;0,0
3544400;Rubiácea;2012;0;0,0;0;0,0;0;0,0
3544509;Rubinéia;2012;0;0,0;0;0,0;0;0,0
3544608;Sabino;2012;0;0,0;0;0,0;0;0,0
3544707;Sagres;2012;0;0,0;0;0,0;0;0,0
3544806;Sales;2012;0;0,0;0;0,0;0;0,0
3545100;Salmourão;2012;0;0,0;0;0,0;0;0,0
3545159;Saltinho;2012;0;0,0;0;0,0;0;0,0
3545506;Sandovalina;2012;0;0,0;0;0,0;0;0,0
3545704;Santa Albertina;2012;0;0,0;0;0,0;0;0,0
3546009;Santa Branca;2012;0;0,0;0;0,0;0;0,0
3546108;Santa Clara d'Oeste;2012;0;0,0;0;0,0;0;0,0
3546207;Santa Cruz da Conceição;2012;0;0,0;0;0,0;0;0,0
3546256;Santa Cruz da Esperança;2012;0;0,0;0;0,0;0;0,0
3546504;Santa Ernestina;2012;0;0,0;0;0,0;0;0,0
3546702;Santa Gertrudes;2012;0;0,0;0;0,0;0;0,0
3546900;Santa Lúcia;2012;0;0,0;0;0,0;0;0,0
3547106;Santa Mercedes;2012;0;0,0;0;0,0;0;0,0
3547205;Santana da Ponte Pensa;2012;0;0,0;0;0,0;0;0,0
3547403;Santa Rita d'Oeste;2012;0;0,0;0;0,0;0;0,0
3547650;Santa Salete;2012;0;0,0;0;0,0;0;0,0
3548005;Santo Antônio de Posse;2012;0;0,0;0;0,0;0;0,0
3548054;Santo Antônio do Aracanguá;2012;0;0,0;0;0,0;0;0,0
3548104;Santo Antônio do Jardim;2012;0;0,0;0;0,0;0;0,0
3548203;Santo Antônio do Pinhal;2012;0;0,0;0;0,0;0;0,0
3548302;Santo Expedito;2012;0;0,0;0;0,0;0;0,0
3548401;Santópolis do Aguapeí;2012;0;0,0;0;0,0;0;0,0
3549003;São Francisco;2012;0;0,0;0;0,0;0;0,0
3549201;São João das Duas Pontes;2012;0;0,0;0;0,0;0;0,0
3549250;São João de Iracema;2012;0;0,0;0;0,0;0;0,0
3549300;São João do Pau d'Alho;2012;0;0,0;0;0,0;0;0,0
3549508;São José da Bela Vista;2012;0;0,0;0;0,0;0;0,0
3549607;São José do Barreiro;2012;0;0,0;0;0,0;0;0,0
3549953;São Lourenço da Serra;2012;0;0,0;0;0,0;0;0,0
3550506;São Pedro do Turvo;2012;0;0,0;0;0,0;0;0,0
3551108;Sarapuí;2012;0;0,0;0;0,0;0;0,0
3551207;Sarutaiá;2012;0;0,0;0;0,0;0;0,0
3551306;Sebastianópolis do Sul;2012;0;0,0;0;0,0;0;0,0
3551405;Serra Azul;2012;0;0,0;0;0,0;0;0,0
3551801;Sete Barras;2012;0;0,0;0;0,0;0;0,0
3551900;Severínia;2012;0;0,0;0;0,0;0;0,0
3552551;Suzanápolis;2012;0;0,0;0;0,0;0;0,0
3552908;Taciba;2012;0;0,0;0;0,0;0;0,0
3553104;Taiaçu;2012;0;0,0;0;0,0;0;0,0
3553500;Tapiraí;2012;0;0,0;0;0,0;0;0,0
3553658;Taquaral;2012;0;0,0;0;0,0;0;0,0
3553856;Taquarivaí;2012;0;0,0;0;0,0;0;0,0
3553906;Tarabai;2012;0;0,0;0;0,0;0;0,0
3553955;Tarumã;2012;0;0,0;0;0,0;0;0,0
3554201;Tejupá;2012;0;0,0;0;0,0;0;0,0
3554607;Timburi;2012;0;0,0;0;0,0;0;0,0
3554656;Torre de Pedra;2012;0;0,0;0;0,0;0;0,0
3554755;Trabiju;2012;0;0,0;0;0,0;0;0,0
3554904;Três Fronteiras;2012;0;0,0;0;0,0;0;0,0
3554953;Tuiuti;2012;0;0,0;0;0,0;0;0,0
3555208;Turiúba;2012;0;0,0;0;0,0;0;0,0
3555307;Turmalina;2012;0;0,0;0;0,0;0;0,0
3555356;Ubarana;2012;0;0,0;0;0,0;0;0,0
3555505;Ubirajara;2012;0;0,0;0;0,0;0;0,0
3555604;Uchoa;2012;0;0,0;0;0,0;0;0,0
3555703;União Paulista;2012;0;0,0;0;0,0;0;0,0
3555901;Uru;2012;0;0,0;0;0,0;0;0,0
3556107;Valentim Gentil;2012;0;0,0;0;0,0;0;0,0
3556354;Vargem;2012;0;0,0;0;0,0;0;0,0
3556453;Vargem Grande Paulista;2012;0;0,0;0;0,0;0;0,0
3556602;Vera Cruz;2012;0;0,0;0;0,0;0;0,0
3556958;Vitória Brasil;2012;0;0,0;0;0,0;0;0,0
3557154;Zacarias;2012;0;0,0;0;0,0;0;0,0
3557303;Estiva Gerbi;2012;0;0,0;0;0,0;0;0,0
3500600;Águas de São Pedro;2012;4;1,4;4;1,4;0;0,0
3501707;Américo Brasiliense;2012;264;7,4;264;7,4;0;0,0
3503109;Arandu;2012;16;2,6;16;2,6;0;0,0
3504909;Bananal;2012;15;1,5;15;1,5;0;0,0
3505609;Barrinha;2012;29;1,0;29;1,0;0;0,0
3506359;Bertioga;2012;50;1,0;50;1,0;0;0,0
3507100;Bom Jesus dos Perdões;2012;11;0,5;11;0,5;0;0,0
3509254;Cajati;2012;13;0,5;13;0,5;0;0,0
3509601;Campo Limpo Paulista;2012;56;0,7;56;0,7;0;0,0
3513900;Divinolândia;2012;198;17,8;198;17,8;0;0,0
3514809;Eldorado;2012;2;0,1;2;0,1;0;0,0
3514908;Elias Fausto;2012;6;0,4;6;0,4;0;0,0
3515004;Embu das Artes;2012;77;0,3;77;0,3;0;0,0
3515103;Embu-Guaçu;2012;16;0,3;16;0,3;0;0,0
3515707;Ferraz de Vasconcelos;2012;193;1,1;193;1,1;0;0,0
3517604;Guapiara;2012;19;1,1;19;1,1;0;0,0
3519204;Iacri;2012;15;2,3;15;2,3;0;0,0
3519303;Ibaté;2012;32;1,0;32;1,0;0;0,0
3519709;Ibiúna;2012;63;0,9;63;0,9;0;0,0
3519907;Iepê;2012;20;2,6;20;2,6;0;0,0
3520202;Igaratá;2012;15;1,7;15;1,7;0;0,0
3520301;Iguape;2012;13;0,4;13;0,4;0;0,0
3521002;Iperó;2012;15;0,5;15;0,5;0;0,0
3522109;Itanhaém;2012;77;0,9;77;0,9;0;0,0
3524204;Jaborandi;2012;17;2,6;17;2,6;0;0,0
3524709;Jaguariúna;2012;75;1,6;75;1,6;0;0,0
3526100;Juquiá;2012;15;0,8;15;0,8;0;0,0
3526209;Juquitiba;2012;24;0,8;24;0,8;0;0,0
3528502;Mairiporã;2012;47;0,6;47;0,6;0;0,0
3529906;Miracatu;2012;16;0,8;16;0,8;0;0,0
3531100;Mongaguá;2012;44;0,9;44;0,9;0;0,0
3532108;Murutinga do Sul;2012;22;5,2;22;5,2;0;0,0
3532405;Nazaré Paulista;2012;24;1,4;24;1,4;0;0,0
3533403;Nova Odessa;2012;53;1,0;53;1,0;0;0,0
3535804;Paranapanema;2012;30;1,6;30;1,6;0;0,0
3536208;Pariquera-Açu;2012;152;8,2;152;8,2;0;0,0
3536505;Paulínia;2012;84;1,0;84;1,0;0;0,0
3537602;Peruíbe;2012;39;0,6;39;0,6;0;0,0
3539202;Pirapozinho;2012;59;2,3;59;2,3;0;0,0
3539806;Poá;2012;21;0,2;21;0,2;0;0,0
3540002;Pompéia;2012;41;2,0;41;2,0;0;0,0
3541604;Promissão;2012;78;2,1;78;2,1;0;0,0
3541901;Queluz;2012;26;2,2;26;2,2;0;0,0
3544251;Rosana;2012;57;2,9;57;2,9;0;0,0
3544301;Roseira;2012;14;1,4;14;1,4;0;0,0
3547007;Santa Maria da Serra;2012;5;0,9;5;0,9;0;0,0
3547304;Santana de Parnaíba;2012;20;0,2;20;0,2;0;0,0
3547908;Santo Antônio da Alegria;2012;12;1,9;12;1,9;0;0,0
3550209;São Miguel Arcanjo;2012;6;0,2;6;0,2;0;0,0
3552007;Silveiras;2012;3;0,5;3;0,5;0;0,0
3552304;Sud Mennucci;2012;20;2,7;20;2,7;0;0,0
3553203;Taiúva;2012;4;0,7;4;0,7;0;0,0
3556503;Várzea Paulista;2012;36;0,3;36;0,3;0;0,0
3556909;Vista Alegre do Alto;2012;9;1,3;9;1,3;0;0,0
3507407;Borborema;2012;26;1,8;16;1,1;10;0,7
3510005;Cândido Mota;2012;50;1,7;40;1,3;10;0,3
3511904;Clementina;2012;30;4,1;20;2,7;10;1,4
3512100;Colômbia;2012;30;5,0;20;3,3;10;1,7
3537107;Pedreira;2012;49;1,2;39;0,9;10;0,2
3538907;Pirajuí;2012;303;13,3;293;12,8;10;0,4
3540408;Populina;2012;18;4,3;8;1,9;10;2,4
3540606;Porto Feliz;2012;45;0,9;35;0,7;10;0,2
3541307;Presidente Epitácio;2012;78;1,9;68;1,6;10;0,2
3544905;Sales Oliveira;2012;29;2,7;19;1,8;10;0,9
3505807;Bastos;2012;35;1,7;28;1,4;7;0,3
3508603;Cachoeira Paulista;2012;47;1,5;40;1,3;7;0,2
3508702;Caconde;2012;65;3,5;58;3,1;7;0,4
3511706;Charqueada;2012;33;2,1;26;1,7;7;0,5
3512001;Colina;2012;47;2,7;40;2,3;7;0,4
3512308;Conchas;2012;42;2,6;35;2,1;7;0,4
3517802;Guaraçaí;2012;27;3,2;20;2,4;7;0,8
3518305;Guararema;2012;35;1,3;28;1,1;7;0,3
3523503;Itatinga;2012;14;0,8;7;0,4;7;0,4
3525508;Joanópolis;2012;24;2,0;17;1,4;7;0,6
3527306;Louveira;2012;41;1,0;34;0,9;7;0,2
3531803;Monte Mor;2012;45;0,9;38;0,7;7;0,1
3542404;Regente Feijó;2012;24;1,3;17;0,9;7;0,4
3554706;Torrinha;2012;20;2,1;13;1,4;7;0,7
3507902;Brotas;2012;41;1,9;35;1,6;6;0,3
3509304;Cajobi;2012;32;3,3;26;2,6;6;0,6
3514304;Dourado;2012;18;2,1;12;1,4;6;0,7
3536000;Parapuã;2012;32;3,0;26;2,4;6;0,6
3554300;Teodoro Sampaio;2012;58;2,7;52;2,4;6;0,3
3508405;Cabreúva;2012;36;0,8;28;0,6;8;0,2
3517703;Guará;2012;30;1,5;22;1,1;8;0,4
3520004;Igaraçu do Tietê;2012;63;2,7;55;2,3;8;0,3
3537909;Pilar do Sul;2012;35;1,3;27;1,0;8;0,3
3538600;Piracaia;2012;37;1,5;29;1,1;8;0,3
3540804;Potirendaba;2012;28;1,8;20;1,3;8;0,5
3542909;Ribeirão Bonito;2012;17;1,4;9;0,7;8;0,7
3550704;São Sebastião;2012;101;1,3;93;1,2;8;0,1
3550902;São Simão;2012;40;2,8;32;2,2;8;0,6
3552106;Socorro;2012;62;1,7;54;1,5;8;0,2
3502705;Apiaí;2012;47;1,9;42;1,7;5;0,2
3514502;Duartina;2012;82;6,7;77;6,3;5;0,4
3515202;Estrela d'Oeste;2012;14;1,7;9;1,1;5;0,6
3532900;Nova Europa;2012;12;1,3;7;0,7;5;0,5
3553005;Taguaí;2012;17;1,5;12;1,1;5;0,4
3501301;Álvares Machado;2012;20;0,8;18;0,8;2;0,1
3503406;Arealva;2012;24;3,0;22;2,8;2;0,3
3506706;Boa Esperança do Sul;2012;15;1,1;13;0,9;2;0,1
3513108;Cravinhos;2012;15;0,5;13;0,4;2;0,1
3519105;Iacanga;2012;27;2,6;25;2,4;2;0,2
3535606;Paraibuna;2012;14;0,8;12;0,7;2;0,1
3527405;Lucélia;2012;67;3,3;48;2,4;19;0,9
3528106;Macaubal;2012;24;3,1;5;0,7;19;2,5
3529708;Miguelópolis;2012;66;3,2;47;2,3;19;0,9
3535507;Paraguaçu Paulista;2012;97;2,3;78;1,8;19;0,4
3547700;Santo Anastácio;2012;56;2,7;37;1,8;19;0,9
3552601;Tabapuã;2012;30;2,6;11;1,0;19;1,7
3553807;Taquarituba;2012;55;2,4;36;1,6;19;0,8
3556008;Urupês;2012;34;2,7;15;1,2;19;1,5
3509403;Cajuru;2012;68;2,9;50;2,1;18;0,8
3510203;Capão Bonito;2012;67;1,5;49;1,1;18;0,4
3519402;Ibirá;2012;27;2,4;9;0,8;18;1,6
3520103;Igarapava;2012;50;1,8;32;1,1;18;0,6
3533908;Olímpia;2012;94;1,9;76;1,5;18;0,4
3539509;Pitangueiras;2012;50;1,4;32;0,9;18;0,5
3503802;Artur Nogueira;2012;12;0,3;0;0,0;12;0,3
3536307;Patrocínio Paulista;2012;35;2,6;23;1,7;12;0,9
3546801;Santa Isabel;2012;102;2,0;90;1,8;12;0,2
3547601;Santa Rosa de Viterbo;2012;30;1,2;18;0,7;12;0,5
3502754;Araçariguama;2012;4;0,2;0;0,0;4;0,2
3511003;Castilho;2012;25;1,3;21;1,1;4;0,2
3513504;Cubatão;2012;138;1,1;134;1,1;4;0,0
3523602;Itirapina;2012;24;1,5;20;1,3;4;0,3
3528809;Maracaí;2012;26;1,9;22;1,6;4;0,3
3539400;Piratininga;2012;30;2,4;26;2,1;4;0,3
3550803;São Sebastião da Grama;2012;30;2,5;26;2,2;4;0,3
3552403;Sumaré;2012;184;0,7;180;0,7;4;0,0
3501103;Alto Alegre;2012;22;5,4;19;4,6;3;0,7
3502200;Angatuba;2012;57;2,5;54;2,4;3;0,1
3520400;Ilhabela;2012;40;1,4;37;1,3;3;0,1
3534906;Pacaembu;2012;32;2,4;29;2,2;3;0,2
3545001;Salesópolis;2012;24;1,5;21;1,3;3;0,2
3508801;Cafelândia;2012;58;3,5;47;2,8;11;0,7
3512209;Conchal;2012;52;2,0;41;1,6;11;0,4
3522901;Itapuí;2012;33;2,6;22;1,8;11;0,9
3541208;Presidente Bernardes;2012;51;3,7;40;2,9;11;0,8
3554805;Tremembé;2012;30;0,7;19;0,5;11;0,3
3510708;Cardoso;2012;31;2,6;18;1,5;13;1,1
3511607;Cesário Lange;2012;30;1,9;17;1,1;13;0,8
3519006;Herculândia;2012;32;3,6;19;2,2;13;1,5
3528007;Macatuba;2012;31;1,9;18;1,1;13;0,8
3543808;Rinópolis;2012;33;3,3;20;2,0;13;1,3
3551603;Serra Negra;2012;55;2,1;42;1,6;13;0,5
3552700;Tabatinga;2012;35;2,3;22;1,5;13;0,9
3553302;Tambaú;2012;36;1,6;23;1,0;13;0,6
3553609;Tapiratiba;2012;34;2,7;21;1,7;13;1,0
3503703;Ariranha;2012;25;2,9;4;0,5;21;2,4
3506409;Bilac;2012;35;4,9;14;1,9;21;2,9
3514106;Dois Córregos;2012;65;2,6;44;1,7;21;0,8
3516606;Gália;2012;45;6,5;24;3,5;21;3,0
3516903;General Salgado;2012;32;3,0;11;1,0;21;2,0
3518602;Guariba;2012;72;2,0;51;1,4;21;0,6
3521903;Itajobi;2012;36;2,5;15;1,0;21;1,4
3525201;Jarinu;2012;33;1,3;12;0,5;21;0,8
3531506;Monte Azul Paulista;2012;70;3,7;49;2,6;21;1,1
3546306;Santa Cruz das Palmeiras;2012;43;1,4;22;0,7;21;0,7
3501004;Altinópolis;2012;30;1,9;21;1,3;9;0,6
3511409;Cerqueira César;2012;42;2,4;33;1,8;9;0,5
3515400;Fartura;2012;26;1,7;17;1,1;9;0,6
3517000;Getulina;2012;51;4,7;42;3,9;9;0,8
3538808;Piraju;2012;80;2,8;71;2,5;9;0,3
3508108;Buritama;2012;42;2,7;22;1,4;20;1,3
3521309;Ipuã;2012;48;3,3;28;1,9;20;1,4
3535408;Panorama;2012;65;4,4;45;3,1;20;1,4
3536703;Pederneiras;2012;72;1,7;52;1,2;20;0,5
3537008;Pedregulho;2012;53;3,4;33;2,1;20;1,3
3545605;Santa Adélia;2012;31;2,1;11;0,8;20;1,4
3513702;Descalvado;2012;38;1,2;23;0,7;15;0,5
3536604;Paulo de Faria;2012;24;2,8;9;1,1;15;1,8
3544004;Rio das Pedras;2012;53;1,7;38;1,2;15;0,5
3550001;São Luiz do Paraitinga;2012;26;2,5;11;1,1;15;1,4
3551504;Serrana;2012;58;1,5;43;1,1;15;0,4
3500105;Adamantina;2012;300;8,9;263;7,8;37;1,1
3500303;Aguaí;2012;76;2,3;49;1,5;27;0,8
3500709;Agudos;2012;65;1,9;43;1,2;22;0,6
3501608;Americana;2012;686;3,2;343;1,6;343;1,6
3501905;Amparo;2012;469;7,0;356;5,3;113;1,7
3502101;Andradina;2012;100;1,8;64;1,2;36;0,6
3502507;Aparecida;2012;84;2,4;50;1,4;34;1,0
3502606;Aparecida d'Oeste;2012;30;6,8;8;1,8;22;5,0
3502804;Araçatuba;2012;660;3,6;495;2,7;165;0,9
3502903;Araçoiaba da Serra;2012;90;3,2;0;0,0;90;3,2
3503208;Araraquara;2012;587;2,8;278;1,3;309;1,5
3503307;Araras;2012;578;4,8;289;2,4;289;2,4
3503901;Arujá;2012;82;1,1;15;0,2;67;0,9
3504008;Assis;2012;389;4,0;245;2,5;144;1,5
3504107;Atibaia;2012;187;1,4;48;0,4;139;1,1
3504503;Avaré;2012;153;1,8;95;1,1;58;0,7
3505203;Bariri;2012;68;2,1;52;1,6;16;0,5
3505302;Barra Bonita;2012;101;2,9;68;1,9;33;0,9
3505500;Barretos;2012;607;5,4;492;4,3;115;1,0
3505708;Barueri;2012;477;1,9;381;1,6;96;0,4
3505906;Batatais;2012;139;2,4;94;1,6;45;0,8
3506003;Bauru;2012;1.128;3,2;711;2,0;417;1,2
3506102;Bebedouro;2012;155;2,1;107;1,4;48;0,6
3506300;Bernardino de Campos;2012;50;4,6;16;1,5;34;3,2
3506508;Birigui;2012;262;2,4;170;1,5;92;0,8
3507001;Boituva;2012;55;1,1;39;0,8;16;0,3
3507506;Botucatu;2012;604;4,6;497;3,8;107;0,8
3507605;Bragança Paulista;2012;331;2,2;203;1,4;128;0,9
3508504;Caçapava;2012;132;1,5;63;0,7;69;0,8
3509007;Caieiras;2012;68;0,8;29;0,3;39;0,4
3509205;Cajamar;2012;171;2,6;71;1,1;100;1,5
3509502;Campinas;2012;2.948;2,7;1.351;1,2;1.597;1,5
3509700;Campos do Jordão;2012;376;7,8;329;6,8;47;1,0
3510401;Capivari;2012;119;2,4;58;1,2;61;1,2
3510500;Caraguatatuba;2012;158;1,5;120;1,2;38;0,4
3510609;Carapicuíba;2012;353;0,9;263;0,7;90;0,2
3510807;Casa Branca;2012;412;14,4;395;13,8;17;0,6
3511102;Catanduva;2012;526;4,6;396;3,5;130;1,1
3511508;Cerquilho;2012;42;1,0;26;0,6;16;0,4
3512803;Cosmópolis;2012;103;1,7;74;1,2;29;0,5
3513009;Cotia;2012;287;1,4;189;0,9;98;0,5
3513405;Cruzeiro;2012;152;2,0;107;1,4;45;0,6
3513603;Cunha;2012;40;1,8;24;1,1;16;0,7
3513801;Diadema;2012;658;1,7;585;1,5;73;0,2
3514403;Dracena;2012;143;3,3;108;2,5;35;0,8
3515186;Espírito Santo do Pinhal;2012;458;10,9;369;8,8;89;2,1
3515509;Fernandópolis;2012;172;2,6;92;1,4;80;1,2
3516200;Franca;2012;663;2,0;424;1,3;239;0,7
3516309;Francisco Morato;2012;144;0,9;95;0,6;49;0,3
3516408;Franco da Rocha;2012;654;4,8;424;3,1;230;1,7
3516705;Garça;2012;376;8,7;331;7,7;45;1,0
3517406;Guaíra;2012;70;1,9;43;1,1;27;0,7
3518404;Guaratinguetá;2012;326;2,9;274;2,4;52;0,5
3518701;Guarujá;2012;276;0,9;208;0,7;68;0,2
3518800;Guarulhos;2012;1.922;1,5;1.432;1,1;490;0,4
3519071;Hortolândia;2012;94;0,5;65;0,3;29;0,1
3519600;Ibitinga;2012;93;1,7;52;1,0;41;0,8
3520442;Ilha Solteira;2012;116;4,6;74;2,9;42;1,7
3520509;Indaiatuba;2012;346;1,6;258;1,2;88;0,4
3520707;Indiaporã;2012;40;10,3;5;1,3;35;9,0
3520905;Ipaussu;2012;49;3,5;21;1,5;28;2,0
3521804;Itaí;2012;41;1,7;40;1,6;1;0,0
3522208;Itapecerica da Serra;2012;472;3,0;282;1,8;190;1,2
3522307;Itapetininga;2012;129;0,9;93;0,6;36;0,2
3522406;Itapeva;2012;195;2,2;141;1,6;54;0,6
3522505;Itapevi;2012;254;1,2;205;1,0;49;0,2
3522604;Itapira;2012;1.377;19,9;838;12,1;539;7,8
3522703;Itápolis;2012;73;1,8;45;1,1;28;0,7
3522802;Itaporanga;2012;49;3,4;33;2,3;16;1,1
3523107;Itaquaquecetuba;2012;254;0,8;224;0,7;30;0,1
3523206;Itararé;2012;97;2,0;80;1,7;17;0,4
3523404;Itatiba;2012;112;1,1;60;0,6;52;0,5
3523909;Itu;2012;426;2,7;391;2,5;35;0,2
3524006;Itupeva;2012;86;1,8;48;1,0;38;0,8
3524105;Ituverava;2012;120;3,1;58;1,5;62;1,6
3524303;Jaboticabal;2012;136;1,9;66;0,9;70;1,0
3524402;Jacareí;2012;383;1,8;205;1,0;178;0,8
3524501;Jaci;2012;177;29,9;135;22,8;42;7,1
3524808;Jales;2012;144;3,1;70;1,5;74;1,6
3525003;Jandira;2012;58;0,5;44;0,4;14;0,1
3525300;Jaú;2012;919;6,8;733;5,5;186;1,4
3525706;José Bonifácio;2012;61;1,8;34;1,0;27;0,8
3525904;Jundiaí;2012;641;1,7;282;0,7;359;0,9
3526001;Junqueirópolis;2012;52;2,7;26;1,4;26;1,4
3526407;Laranjal Paulista;2012;47;1,8;33;1,3;14;0,5
3526704;Leme;2012;127;1,4;76;0,8;51;0,5
3526803;Lençóis Paulista;2012;80;1,3;57;0,9;23;0,4
3526902;Limeira;2012;431;1,5;237;0,8;194;0,7
3527108;Lins;2012;484;6,7;379;5,2;105;1,5
3527207;Lorena;2012;173;2,1;105;1,3;68;0,8
3527702;Luiziânia;2012;32;6,2;15;2,9;17;3,3
3529005;Marília;2012;887;4,0;728;3,3;159;0,7
3529203;Martinópolis;2012;66;2,7;41;1,7;25;1,0
3529302;Matão;2012;164;2,1;96;1,2;68;0,9
3529401;Mauá;2012;512;1,2;236;0,6;276;0,6
3530102;Mirandópolis;2012;126;4,5;96;3,5;30;1,1
3530300;Mirassol;2012;93;1,7;24;0,4;69;1,3
3530508;Mococa;2012;140;2,1;98;1,5;42;0,6
3530607;Mogi das Cruzes;2012;736;1,9;561;1,4;175;0,4
3530706;Mogi Guaçu;2012;329;2,4;149;1,1;180;1,3
3530805;Mogi Mirim;2012;264;3,0;140;1,6;124;1,4
3531308;Monte Alto;2012;109;2,3;58;1,2;51;1,1
3531407;Monte Aprazível;2012;80;3,6;35;1,6;45;2,0
3531902;Morro Agudo;2012;45;1,5;31;1,0;14;0,5
3532009;Morungaba;2012;42;3,5;13;1,1;29;2,4
3532504;Neves Paulista;2012;34;3,9;11;1,3;23;2,6
3532603;Nhandeara;2012;124;11,5;36;3,3;88;8,2
3533007;Nova Granada;2012;193;9,9;42;2,2;151;7,7
3533502;Novo Horizonte;2012;105;2,8;38;1,0;67;1,8
3534302;Orlândia;2012;118;2,9;72;1,8;46;1,1
3534401;Osasco;2012;909;1,4;599;0,9;310;0,5
3534609;Osvaldo Cruz;2012;118;3,8;71;2,3;47;1,5
3534708;Ourinhos;2012;315;3,0;230;2,2;85;0,8
3534757;Ouroeste;2012;39;4,5;10;1,2;29;3,3
3535200;Palmeira d'Oeste;2012;24;2,5;10;1,1;14;1,5
3535309;Palmital;2012;68;3,2;44;2,1;24;1,1
3537305;Penápolis;2012;238;4,0;168;2,8;70;1,2
3537404;Pereira Barreto;2012;98;3,9;65;2,6;33;1,3
3537800;Piedade;2012;515;9,8;471;9,0;44;0,8
3538006;Pindamonhangaba;2012;170;1,1;117;0,8;53;0,4
3538709;Piracicaba;2012;807;2,2;316;0,9;491;1,3
3539004;Pirangi;2012;37;3,5;9;0,8;28;2,6
3539301;Pirassununga;2012;87;1,2;52;0,7;35;0,5
3540200;Pontal;2012;75;1,8;45;1,1;30;0,7
3540705;Porto Ferreira;2012;61;1,2;37;0,7;24;0,5
3541000;Praia Grande;2012;199;0,7;113;0,4;86;0,3
3541406;Presidente Prudente;2012;1.608;7,6;1.094;5,2;514;2,4
3541505;Presidente Venceslau;2012;97;2,6;75;2,0;22;0,6
3542206;Rancharia;2012;98;3,4;70;2,4;28;1,0
3542602;Registro;2012;105;1,9;63;1,2;42;0,8
3543006;Ribeirão Branco;2012;36;2,0;35;1,9;1;0,1
3543303;Ribeirão Pires;2012;164;1,4;50;0,4;114;1,0
3543402;Ribeirão Preto;2012;1.918;3,1;1.374;2,2;544;0,9
3543907;Rio Claro;2012;510;2,7;274;1,4;236;1,2
3544202;Riolândia;2012;36;3,4;7;0,7;29;2,7
3545209;Salto;2012;123;1,1;70;0,7;53;0,5
3545308;Salto de Pirapora;2012;1.018;24,9;992;24,2;26;0,6
3545407;Salto Grande;2012;34;3,8;17;1,9;17;1,9
3545803;Santa Bárbara d'Oeste;2012;136;0,7;105;0,6;31;0,2
3546405;Santa Cruz do Rio Pardo;2012;102;2,3;59;1,3;43;1,0
3546603;Santa Fé do Sul;2012;76;2,6;33;1,1;43;1,5
3547502;Santa Rita do Passa Quatro;2012;299;11,3;271;10,2;28;1,1
3547809;Santo André;2012;1.501;2,2;669;1,0;832;1,2
3548500;Santos;2012;1.643;3,9;737;1,8;906;2,2
3548609;São Bento do Sapucaí;2012;40;3,8;24;2,3;16;1,5
3548708;São Bernardo do Campo;2012;1.474;1,9;759;1,0;715;0,9
3548807;São Caetano do Sul;2012;541;3,6;163;1,1;378;2,5
3548906;São Carlos;2012;419;1,9;204;0,9;215;1,0
3549102;São João da Boa Vista;2012;190;2,3;84;1,0;106;1,3
3549409;São Joaquim da Barra;2012;115;2,4;68;1,4;47;1,0
3549706;São José do Rio Pardo;2012;145;2,8;89;1,7;56;1,1
3549805;São José do Rio Preto;2012;1.695;4,1;992;2,4;703;1,7
3549904;São José dos Campos;2012;1.457;2,3;832;1,3;625;1,0
3550100;São Manuel;2012;36;0,9;22;0,6;14;0,4
3550308;São Paulo;2012;28.669;2,5;15.084;1,3;13.585;1,2
3550407;São Pedro;2012;62;1,9;37;1,1;25;0,8
3550605;São Roque;2012;103;1,3;54;0,7;49;0,6
3551009;São Vicente;2012;220;0,7;165;0,5;55;0,2
3551702;Sertãozinho;2012;155;1,4;75;0,7;80;0,7
3552205;Sorocaba;2012;2.590;4,3;2.159;3,6;431;0,7
3552502;Suzano;2012;187;0,7;106;0,4;81;0,3
3552809;Taboão da Serra;2012;563;2,2;332;1,3;231;0,9
3553401;Tanabi;2012;72;3,0;38;1,6;34;1,4
3553708;Taquaritinga;2012;116;2,1;69;1,3;47;0,9
3554003;Tatuí;2012;159;1,4;100;0,9;59;0,5
3554102;Taubaté;2012;486;1,7;319;1,1;167;0,6
3554508;Tietê;2012;60;1,6;35;0,9;25;0,7
3555000;Tupã;2012;864;13,6;791;12,5;73;1,2
3555406;Ubatuba;2012;92;1,1;68;0,8;24;0,3
3555802;Urânia;2012;38;4,3;9;1,0;29;3,3
3556206;Valinhos;2012;165;1,5;65;0,6;100;0,9
3556305;Valparaíso;2012;55;2,4;31;1,4;24;1,1
3556404;Vargem Grande do Sul;2012;88;2,2;53;1,3;35;0,9
3556701;Vinhedo;2012;95;1,4;59;0,9;36;0,5
3556800;Viradouro;2012;54;3,1;20;1,1;34;1,9
3557006;Votorantim;2012;146;1,3;84;0,8;62;0,6
3557105;Votuporanga;2012;240;2,8;118;1,4;122;1,4
3557204;Chavantes;2012;48;4,0;20;1,6;28;2,3
3500501;Águas de Lindóia;2012;42;2,4;30;1,7;12;0,7
3504206;Auriflama;2012;51;3,6;30;2,1;21;1,5
3506805;Bocaina;2012;35;3,1;30;2,7;5;0,4
3516002;Flórida Paulista;2012;47;3,7;30;2,4;17;1,3
3518206;Guararapes;2012;74;2,4;30;1,0;44;1,4
3521705;Itaberá;2012;35;2,0;30;1,7;5;0,3
3554409;Terra Roxa;2012;34;3,9;30;3,5;4;0,5
3555109;Tupi Paulista;2012;48;3,3;30;2,1;18;1,2
3500204;Adolfo;2011;0;0,0;0;0,0;0;0,0
3500402;Águas da Prata;2011;0;0,0;0;0,0;0;0,0
3500550;Águas de Santa Bárbara;2011;0;0,0;0;0,0;0;0,0
3500758;Alambari;2011;0;0,0;0;0,0;0;0,0
3500808;Alfredo Marcondes;2011;0;0,0;0;0,0;0;0,0
3500907;Altair;2011;0;0,0;0;0,0;0;0,0
3501152;Alumínio;2011;0;0,0;0;0,0;0;0,0
3501202;Álvares Florence;2011;0;0,0;0;0,0;0;0,0
3501400;Álvaro de Carvalho;2011;0;0,0;0;0,0;0;0,0
3501509;Alvinlândia;2011;0;0,0;0;0,0;0;0,0
3501806;Américo de Campos;2011;0;0,0;0;0,0;0;0,0
3502002;Analândia;2011;0;0,0;0;0,0;0;0,0
3502309;Anhembi;2011;0;0,0;0;0,0;0;0,0
3502408;Anhumas;2011;0;0,0;0;0,0;0;0,0
3502903;Araçoiaba da Serra;2011;0;0,0;0;0,0;0;0,0
3503000;Aramina;2011;0;0,0;0;0,0;0;0,0
3503158;Arapeí;2011;0;0,0;0;0,0;0;0,0
3503356;Arco-Íris;2011;0;0,0;0;0,0;0;0,0
3503505;Areias;2011;0;0,0;0;0,0;0;0,0
3503604;Areiópolis;2011;0;0,0;0;0,0;0;0,0
3503950;Aspásia;2011;0;0,0;0;0,0;0;0,0
3504305;Avaí;2011;0;0,0;0;0,0;0;0,0
3504404;Avanhandava;2011;0;0,0;0;0,0;0;0,0
3504602;Bady Bassitt;2011;0;0,0;0;0,0;0;0,0
3504701;Balbinos;2011;0;0,0;0;0,0;0;0,0
3504800;Bálsamo;2011;0;0,0;0;0,0;0;0,0
3505005;Barão de Antonina;2011;0;0,0;0;0,0;0;0,0
3505104;Barbosa;2011;0;0,0;0;0,0;0;0,0
3505351;Barra do Chapéu;2011;0;0,0;0;0,0;0;0,0
3505401;Barra do Turvo;2011;0;0,0;0;0,0;0;0,0
3506201;Bento de Abreu;2011;0;0,0;0;0,0;0;0,0
3506607;Biritiba Mirim;2011;0;0,0;0;0,0;0;0,0
3506904;Bofete;2011;0;0,0;0;0,0;0;0,0
3507159;Bom Sucesso de Itararé;2011;0;0,0;0;0,0;0;0,0
3507209;Borá;2011;0;0,0;0;0,0;0;0,0
3507308;Boracéia;2011;0;0,0;0;0,0;0;0,0
3507456;Borebi;2011;0;0,0;0;0,0;0;0,0
3507704;Braúna;2011;0;0,0;0;0,0;0;0,0
3507753;Brejo Alegre;2011;0;0,0;0;0,0;0;0,0
3507803;Brodowski;2011;0;0,0;0;0,0;0;0,0
3508009;Buri;2011;0;0,0;0;0,0;0;0,0
3508207;Buritizal;2011;0;0,0;0;0,0;0;0,0
3508306;Cabrália Paulista;2011;0;0,0;0;0,0;0;0,0
3508900;Caiabu;2011;0;0,0;0;0,0;0;0,0
3509106;Caiuá;2011;0;0,0;0;0,0;0;0,0
3509452;Campina do Monte Alegre;2011;0;0,0;0;0,0;0;0,0
3509809;Campos Novos Paulista;2011;0;0,0;0;0,0;0;0,0
3509908;Cananéia;2011;0;0,0;0;0,0;0;0,0
3509957;Canas;2011;0;0,0;0;0,0;0;0,0
3510104;Cândido Rodrigues;2011;0;0,0;0;0,0;0;0,0
3510153;Canitar;2011;0;0,0;0;0,0;0;0,0
3510302;Capela do Alto;2011;0;0,0;0;0,0;0;0,0
3510906;Cássia dos Coqueiros;2011;0;0,0;0;0,0;0;0,0
3511201;Catiguá;2011;0;0,0;0;0,0;0;0,0
3511300;Cedral;2011;0;0,0;0;0,0;0;0,0
3512407;Cordeirópolis;2011;0;0,0;0;0,0;0;0,0
3512506;Coroados;2011;0;0,0;0;0,0;0;0,0
3512605;Coronel Macedo;2011;0;0,0;0;0,0;0;0,0
3512704;Corumbataí;2011;0;0,0;0;0,0;0;0,0
3512902;Cosmorama;2011;0;0,0;0;0,0;0;0,0
3513207;Cristais Paulista;2011;0;0,0;0;0,0;0;0,0
3513306;Cruzália;2011;0;0,0;0;0,0;0;0,0
3513850;Dirce Reis;2011;0;0,0;0;0,0;0;0,0
3514007;Dobrada;2011;0;0,0;0;0,0;0;0,0
3514205;Dolcinópolis;2011;0;0,0;0;0,0;0;0,0
3514601;Dumont;2011;0;0,0;0;0,0;0;0,0
3514700;Echaporã;2011;0;0,0;0;0,0;0;0,0
3514924;Elisiário;2011;0;0,0;0;0,0;0;0,0
3514957;Embaúba;2011;0;0,0;0;0,0;0;0,0
3515129;Emilianópolis;2011;0;0,0;0;0,0;0;0,0
3515152;Engenheiro Coelho;2011;0;0,0;0;0,0;0;0,0
3515194;Espírito Santo do Turvo;2011;0;0,0;0;0,0;0;0,0
3515301;Estrela do Norte;2011;0;0,0;0;0,0;0;0,0
3515350;Euclides da Cunha Paulista;2011;0;0,0;0;0,0;0;0,0
3515608;Fernando Prestes;2011;0;0,0;0;0,0;0;0,0
3515657;Fernão;2011;0;0,0;0;0,0;0;0,0
3515806;Flora Rica;2011;0;0,0;0;0,0;0;0,0
3515905;Floreal;2011;0;0,0;0;0,0;0;0,0
3516101;Florínea;2011;0;0,0;0;0,0;0;0,0
3516507;Gabriel Monteiro;2011;0;0,0;0;0,0;0;0,0
3516804;Gastão Vidigal;2011;0;0,0;0;0,0;0;0,0
3516853;Gavião Peixoto;2011;0;0,0;0;0,0;0;0,0
3517109;Glicério;2011;0;0,0;0;0,0;0;0,0
3517208;Guaiçara;2011;0;0,0;0;0,0;0;0,0
3517307;Guaimbê;2011;0;0,0;0;0,0;0;0,0
3517505;Guapiaçu;2011;0;0,0;0;0,0;0;0,0
3517901;Guaraci;2011;0;0,0;0;0,0;0;0,0
3518008;Guarani d'Oeste;2011;0;0,0;0;0,0;0;0,0
3518107;Guarantã;2011;0;0,0;0;0,0;0;0,0
3518503;Guareí;2011;0;0,0;0;0,0;0;0,0
3518859;Guatapará;2011;0;0,0;0;0,0;0;0,0
3518909;Guzolândia;2011;0;0,0;0;0,0;0;0,0
3519055;Holambra;2011;0;0,0;0;0,0;0;0,0
3519253;Iaras;2011;0;0,0;0;0,0;0;0,0
3519501;Ibirarema;2011;0;0,0;0;0,0;0;0,0
3519808;Icém;2011;0;0,0;0;0,0;0;0,0
3520426;Ilha Comprida;2011;0;0,0;0;0,0;0;0,0
3520608;Indiana;2011;0;0,0;0;0,0;0;0,0
3520806;Inúbia Paulista;2011;0;0,0;0;0,0;0;0,0
3521002;Iperó;2011;0;0,0;0;0,0;0;0,0
3521101;Ipeúna;2011;0;0,0;0;0,0;0;0,0
3521150;Ipiguá;2011;0;0,0;0;0,0;0;0,0
3521200;Iporanga;2011;0;0,0;0;0,0;0;0,0
3521408;Iracemápolis;2011;0;0,0;0;0,0;0;0,0
3521507;Irapuã;2011;0;0,0;0;0,0;0;0,0
3521606;Irapuru;2011;0;0,0;0;0,0;0;0,0
3522000;Itaju;2011;0;0,0;0;0,0;0;0,0
3522158;Itaoca;2011;0;0,0;0;0,0;0;0,0
3522653;Itapirapuã Paulista;2011;0;0,0;0;0,0;0;0,0
3523008;Itapura;2011;0;0,0;0;0,0;0;0,0
3523305;Itariri;2011;0;0,0;0;0,0;0;0,0
3523701;Itirapuã;2011;0;0,0;0;0,0;0;0,0
3523800;Itobi;2011;0;0,0;0;0,0;0;0,0
3524600;Jacupiranga;2011;0;0,0;0;0,0;0;0,0
3524907;Jambeiro;2011;0;0,0;0;0,0;0;0,0
3525102;Jardinópolis;2011;0;0,0;0;0,0;0;0,0
3525409;Jeriquara;2011;0;0,0;0;0,0;0;0,0
3525607;João Ramalho;2011;0;0,0;0;0,0;0;0,0
3525805;Júlio Mesquita;2011;0;0,0;0;0,0;0;0,0
3525854;Jumirim;2011;0;0,0;0;0,0;0;0,0
3526308;Lagoinha;2011;0;0,0;0;0,0;0;0,0
3526506;Lavínia;2011;0;0,0;0;0,0;0;0,0
3526605;Lavrinhas;2011;0;0,0;0;0,0;0;0,0
3527009;Lindóia;2011;0;0,0;0;0,0;0;0,0
3527256;Lourdes;2011;0;0,0;0;0,0;0;0,0
3527504;Lucianópolis;2011;0;0,0;0;0,0;0;0,0
3527603;Luís Antônio;2011;0;0,0;0;0,0;0;0,0
3527801;Lupércio;2011;0;0,0;0;0,0;0;0,0
3527900;Lutécia;2011;0;0,0;0;0,0;0;0,0
3528205;Macedônia;2011;0;0,0;0;0,0;0;0,0
3528304;Magda;2011;0;0,0;0;0,0;0;0,0
3528403;Mairinque;2011;0;0,0;0;0,0;0;0,0
3528601;Manduri;2011;0;0,0;0;0,0;0;0,0
3528700;Marabá Paulista;2011;0;0,0;0;0,0;0;0,0
3528858;Marapoama;2011;0;0,0;0;0,0;0;0,0
3528908;Mariápolis;2011;0;0,0;0;0,0;0;0,0
3529104;Marinópolis;2011;0;0,0;0;0,0;0;0,0
3529500;Mendonça;2011;0;0,0;0;0,0;0;0,0
3529609;Meridiano;2011;0;0,0;0;0,0;0;0,0
3529658;Mesópolis;2011;0;0,0;0;0,0;0;0,0
3529807;Mineiros do Tietê;2011;0;0,0;0;0,0;0;0,0
3530003;Mira Estrela;2011;0;0,0;0;0,0;0;0,0
3530201;Mirante do Paranapanema;2011;0;0,0;0;0,0;0;0,0
3530409;Mirassolândia;2011;0;0,0;0;0,0;0;0,0
3530904;Mombuca;2011;0;0,0;0;0,0;0;0,0
3531001;Monções;2011;0;0,0;0;0,0;0;0,0
3531209;Monte Alegre do Sul;2011;0;0,0;0;0,0;0;0,0
3531605;Monte Castelo;2011;0;0,0;0;0,0;0;0,0
3531704;Monteiro Lobato;2011;0;0,0;0;0,0;0;0,0
3532058;Motuca;2011;0;0,0;0;0,0;0;0,0
3532157;Nantes;2011;0;0,0;0;0,0;0;0,0
3532207;Narandiba;2011;0;0,0;0;0,0;0;0,0
3532306;Natividade da Serra;2011;0;0,0;0;0,0;0;0,0
3532702;Nipoã;2011;0;0,0;0;0,0;0;0,0
3532801;Nova Aliança;2011;0;0,0;0;0,0;0;0,0
3532827;Nova Campina;2011;0;0,0;0;0,0;0;0,0
3532843;Nova Canaã Paulista;2011;0;0,0;0;0,0;0;0,0
3532868;Nova Castilho;2011;0;0,0;0;0,0;0;0,0
3533106;Nova Guataporanga;2011;0;0,0;0;0,0;0;0,0
3533205;Nova Independência;2011;0;0,0;0;0,0;0;0,0
3533254;Novais;2011;0;0,0;0;0,0;0;0,0
3533304;Nova Luzitânia;2011;0;0,0;0;0,0;0;0,0
3533601;Nuporanga;2011;0;0,0;0;0,0;0;0,0
3533700;Ocauçu;2011;0;0,0;0;0,0;0;0,0
3533809;Óleo;2011;0;0,0;0;0,0;0;0,0
3534005;Onda Verde;2011;0;0,0;0;0,0;0;0,0
3534104;Oriente;2011;0;0,0;0;0,0;0;0,0
3534203;Orindiúva;2011;0;0,0;0;0,0;0;0,0
3534500;Oscar Bressane;2011;0;0,0;0;0,0;0;0,0
3534807;Ouro Verde;2011;0;0,0;0;0,0;0;0,0
3535002;Palestina;2011;0;0,0;0;0,0;0;0,0
3535101;Palmares Paulista;2011;0;0,0;0;0,0;0;0,0
3535705;Paraíso;2011;0;0,0;0;0,0;0;0,0
3535903;Paranapuã;2011;0;0,0;0;0,0;0;0,0
3536109;Pardinho;2011;0;0,0;0;0,0;0;0,0
3536257;Parisi;2011;0;0,0;0;0,0;0;0,0
3536406;Paulicéia;2011;0;0,0;0;0,0;0;0,0
3536570;Paulistânia;2011;0;0,0;0;0,0;0;0,0
3536802;Pedra Bela;2011;0;0,0;0;0,0;0;0,0
3536901;Pedranópolis;2011;0;0,0;0;0,0;0;0,0
3537156;Pedrinhas Paulista;2011;0;0,0;0;0,0;0;0,0
3537206;Pedro de Toledo;2011;0;0,0;0;0,0;0;0,0
3537503;Pereiras;2011;0;0,0;0;0,0;0;0,0
3537701;Piacatu;2011;0;0,0;0;0,0;0;0,0
3538105;Pindorama;2011;0;0,0;0;0,0;0;0,0
3538204;Pinhalzinho;2011;0;0,0;0;0,0;0;0,0
3538303;Piquerobi;2011;0;0,0;0;0,0;0;0,0
3538501;Piquete;2011;0;0,0;0;0,0;0;0,0
3539103;Pirapora do Bom Jesus;2011;0;0,0;0;0,0;0;0,0
3539608;Planalto;2011;0;0,0;0;0,0;0;0,0
3539707;Platina;2011;0;0,0;0;0,0;0;0,0
3539905;Poloni;2011;0;0,0;0;0,0;0;0,0
3540101;Pongaí;2011;0;0,0;0;0,0;0;0,0
3540259;Pontalinda;2011;0;0,0;0;0,0;0;0,0
3540309;Pontes Gestal;2011;0;0,0;0;0,0;0;0,0
3540507;Porangaba;2011;0;0,0;0;0,0;0;0,0
3540754;Potim;2011;0;0,0;0;0,0;0;0,0
3540853;Pracinha;2011;0;0,0;0;0,0;0;0,0
3540903;Pradópolis;2011;0;0,0;0;0,0;0;0,0
3541059;Pratânia;2011;0;0,0;0;0,0;0;0,0
3541109;Presidente Alves;2011;0;0,0;0;0,0;0;0,0
3541653;Quadra;2011;0;0,0;0;0,0;0;0,0
3541703;Quatá;2011;0;0,0;0;0,0;0;0,0
3541802;Queiroz;2011;0;0,0;0;0,0;0;0,0
3542008;Quintana;2011;0;0,0;0;0,0;0;0,0
3542107;Rafard;2011;0;0,0;0;0,0;0;0,0
3542305;Redenção da Serra;2011;0;0,0;0;0,0;0;0,0
3542503;Reginópolis;2011;0;0,0;0;0,0;0;0,0
3542701;Restinga;2011;0;0,0;0;0,0;0;0,0
3542800;Ribeira;2011;0;0,0;0;0,0;0;0,0
3543105;Ribeirão Corrente;2011;0;0,0;0;0,0;0;0,0
3543204;Ribeirão do Sul;2011;0;0,0;0;0,0;0;0,0
3543238;Ribeirão dos Índios;2011;0;0,0;0;0,0;0;0,0
3543253;Ribeirão Grande;2011;0;0,0;0;0,0;0;0,0
3543501;Riversul;2011;0;0,0;0;0,0;0;0,0
3543600;Rifaina;2011;0;0,0;0;0,0;0;0,0
3543709;Rincão;2011;0;0,0;0;0,0;0;0,0
3544103;Rio Grande da Serra;2011;0;0,0;0;0,0;0;0,0
3544400;Rubiácea;2011;0;0,0;0;0,0;0;0,0
3544509;Rubinéia;2011;0;0,0;0;0,0;0;0,0
3544608;Sabino;2011;0;0,0;0;0,0;0;0,0
3544707;Sagres;2011;0;0,0;0;0,0;0;0,0
3544806;Sales;2011;0;0,0;0;0,0;0;0,0
3545100;Salmourão;2011;0;0,0;0;0,0;0;0,0
3545159;Saltinho;2011;0;0,0;0;0,0;0;0,0
3545506;Sandovalina;2011;0;0,0;0;0,0;0;0,0
3545704;Santa Albertina;2011;0;0,0;0;0,0;0;0,0
3546009;Santa Branca;2011;0;0,0;0;0,0;0;0,0
3546108;Santa Clara d'Oeste;2011;0;0,0;0;0,0;0;0,0
3546207;Santa Cruz da Conceição;2011;0;0,0;0;0,0;0;0,0
3546256;Santa Cruz da Esperança;2011;0;0,0;0;0,0;0;0,0
3546504;Santa Ernestina;2011;0;0,0;0;0,0;0;0,0
3546702;Santa Gertrudes;2011;0;0,0;0;0,0;0;0,0
3546900;Santa Lúcia;2011;0;0,0;0;0,0;0;0,0
3547106;Santa Mercedes;2011;0;0,0;0;0,0;0;0,0
3547205;Santana da Ponte Pensa;2011;0;0,0;0;0,0;0;0,0
3547403;Santa Rita d'Oeste;2011;0;0,0;0;0,0;0;0,0
3547650;Santa Salete;2011;0;0,0;0;0,0;0;0,0
3548005;Santo Antônio de Posse;2011;0;0,0;0;0,0;0;0,0
3548054;Santo Antônio do Aracanguá;2011;0;0,0;0;0,0;0;0,0
3548104;Santo Antônio do Jardim;2011;0;0,0;0;0,0;0;0,0
3548203;Santo Antônio do Pinhal;2011;0;0,0;0;0,0;0;0,0
3548302;Santo Expedito;2011;0;0,0;0;0,0;0;0,0
3548401;Santópolis do Aguapeí;2011;0;0,0;0;0,0;0;0,0
3549003;São Francisco;2011;0;0,0;0;0,0;0;0,0
3549201;São João das Duas Pontes;2011;0;0,0;0;0,0;0;0,0
3549250;São João de Iracema;2011;0;0,0;0;0,0;0;0,0
3549300;São João do Pau d'Alho;2011;0;0,0;0;0,0;0;0,0
3549508;São José da Bela Vista;2011;0;0,0;0;0,0;0;0,0
3549607;São José do Barreiro;2011;0;0,0;0;0,0;0;0,0
3549953;São Lourenço da Serra;2011;0;0,0;0;0,0;0;0,0
3550506;São Pedro do Turvo;2011;0;0,0;0;0,0;0;0,0
3551108;Sarapuí;2011;0;0,0;0;0,0;0;0,0
3551207;Sarutaiá;2011;0;0,0;0;0,0;0;0,0
3551306;Sebastianópolis do Sul;2011;0;0,0;0;0,0;0;0,0
3551405;Serra Azul;2011;0;0,0;0;0,0;0;0,0
3551801;Sete Barras;2011;0;0,0;0;0,0;0;0,0
3551900;Severínia;2011;0;0,0;0;0,0;0;0,0
3552551;Suzanápolis;2011;0;0,0;0;0,0;0;0,0
3552908;Taciba;2011;0;0,0;0;0,0;0;0,0
3553104;Taiaçu;2011;0;0,0;0;0,0;0;0,0
3553500;Tapiraí;2011;0;0,0;0;0,0;0;0,0
3553658;Taquaral;2011;0;0,0;0;0,0;0;0,0
3553856;Taquarivaí;2011;0;0,0;0;0,0;0;0,0
3553906;Tarabai;2011;0;0,0;0;0,0;0;0,0
3553955;Tarumã;2011;0;0,0;0;0,0;0;0,0
3554201;Tejupá;2011;0;0,0;0;0,0;0;0,0
3554607;Timburi;2011;0;0,0;0;0,0;0;0,0
3554656;Torre de Pedra;2011;0;0,0;0;0,0;0;0,0
3554755;Trabiju;2011;0;0,0;0;0,0;0;0,0
3554904;Três Fronteiras;2011;0;0,0;0;0,0;0;0,0
3554953;Tuiuti;2011;0;0,0;0;0,0;0;0,0
3555208;Turiúba;2011;0;0,0;0;0,0;0;0,0
3555307;Turmalina;2011;0;0,0;0;0,0;0;0,0
3555356;Ubarana;2011;0;0,0;0;0,0;0;0,0
3555505;Ubirajara;2011;0;0,0;0;0,0;0;0,0
3555604;Uchoa;2011;0;0,0;0;0,0;0;0,0
3555703;União Paulista;2011;0;0,0;0;0,0;0;0,0
3555901;Uru;2011;0;0,0;0;0,0;0;0,0
3556107;Valentim Gentil;2011;0;0,0;0;0,0;0;0,0
3556354;Vargem;2011;0;0,0;0;0,0;0;0,0
3556453;Vargem Grande Paulista;2011;0;0,0;0;0,0;0;0,0
3556602;Vera Cruz;2011;0;0,0;0;0,0;0;0,0
3556958;Vitória Brasil;2011;0;0,0;0;0,0;0;0,0
3557154;Zacarias;2011;0;0,0;0;0,0;0;0,0
3557303;Estiva Gerbi;2011;0;0,0;0;0,0;0;0,0
3500600;Águas de São Pedro;2011;4;1,5;4;1,5;0;0,0
3501707;Américo Brasiliense;2011;266;7,6;266;7,6;0;0,0
3503109;Arandu;2011;16;2,6;16;2,6;0;0,0
3504909;Bananal;2011;15;1,5;15;1,5;0;0,0
3505609;Barrinha;2011;29;1,0;29;1,0;0;0,0
3506359;Bertioga;2011;51;1,0;51;1,0;0;0,0
3507100;Bom Jesus dos Perdões;2011;11;0,5;11;0,5;0;0,0
3509205;Cajamar;2011;71;1,1;71;1,1;0;0,0
3509254;Cajati;2011;13;0,5;13;0,5;0;0,0
3509601;Campo Limpo Paulista;2011;44;0,6;44;0,6;0;0,0
3510609;Carapicuíba;2011;228;0,6;228;0,6;0;0,0
3513108;Cravinhos;2011;23;0,7;23;0,7;0;0,0
3514809;Eldorado;2011;7;0,5;7;0,5;0;0,0
3514908;Elias Fausto;2011;6;0,4;6;0,4;0;0,0
3515004;Embu das Artes;2011;83;0,3;83;0,3;0;0,0
3515103;Embu-Guaçu;2011;21;0,3;21;0,3;0;0,0
3515707;Ferraz de Vasconcelos;2011;193;1,1;193;1,1;0;0,0
3517604;Guapiara;2011;18;1,0;18;1,0;0;0,0
3519204;Iacri;2011;15;2,3;15;2,3;0;0,0
3519303;Ibaté;2011;23;0,7;23;0,7;0;0,0
3519709;Ibiúna;2011;32;0,4;32;0,4;0;0,0
3519907;Iepê;2011;20;2,6;20;2,6;0;0,0
3520202;Igaratá;2011;15;1,7;15;1,7;0;0,0
3520301;Iguape;2011;34;1,2;34;1,2;0;0,0
3522109;Itanhaém;2011;77;0,9;77;0,9;0;0,0
3524204;Jaborandi;2011;23;3,5;23;3,5;0;0,0
3524709;Jaguariúna;2011;75;1,7;75;1,7;0;0,0
3525201;Jarinu;2011;12;0,5;12;0,5;0;0,0
3526100;Juquiá;2011;17;0,9;17;0,9;0;0,0
3526209;Juquitiba;2011;24;0,8;24;0,8;0;0,0
3528502;Mairiporã;2011;47;0,6;47;0,6;0;0,0
3529906;Miracatu;2011;16;0,8;16;0,8;0;0,0
3531100;Mongaguá;2011;44;0,9;44;0,9;0;0,0
3532108;Murutinga do Sul;2011;22;5,2;22;5,2;0;0,0
3532405;Nazaré Paulista;2011;24;1,4;24;1,4;0;0,0
3533403;Nova Odessa;2011;50;1,0;50;1,0;0;0,0
3535804;Paranapanema;2011;30;1,7;30;1,7;0;0,0
3536208;Pariquera-Açu;2011;159;8,6;159;8,6;0;0,0
3536505;Paulínia;2011;84;1,0;84;1,0;0;0,0
3537602;Peruíbe;2011;43;0,7;43;0,7;0;0,0
3539202;Pirapozinho;2011;59;2,4;59;2,4;0;0,0
3539806;Poá;2011;14;0,1;14;0,1;0;0,0
3540002;Pompéia;2011;41;2,0;41;2,0;0;0,0
3541604;Promissão;2011;78;2,2;78;2,2;0;0,0
3541901;Queluz;2011;26;2,3;26;2,3;0;0,0
3544301;Roseira;2011;14;1,4;14;1,4;0;0,0
3547007;Santa Maria da Serra;2011;5;0,9;5;0,9;0;0,0
3547304;Santana de Parnaíba;2011;28;0,3;28;0,3;0;0,0
3547908;Santo Antônio da Alegria;2011;12;1,9;12;1,9;0;0,0
3550209;São Miguel Arcanjo;2011;6;0,2;6;0,2;0;0,0
3552304;Sud Mennucci;2011;20;2,7;20;2,7;0;0,0
3554706;Torrinha;2011;20;2,1;20;2,1;0;0,0
3556503;Várzea Paulista;2011;31;0,3;31;0,3;0;0,0
3556909;Vista Alegre do Alto;2011;9;1,3;9;1,3;0;0,0
3507407;Borborema;2011;26;1,8;16;1,1;10;0,7
3510005;Cândido Mota;2011;50;1,7;40;1,3;10;0,3
3511904;Clementina;2011;30;4,2;20;2,8;10;1,4
3512100;Colômbia;2011;30;5,0;20;3,3;10;1,7
3532009;Morungaba;2011;40;3,4;30;2,5;10;0,8
3537107;Pedreira;2011;49;1,2;39;0,9;10;0,2
3538600;Piracaia;2011;35;1,4;25;1,0;10;0,4
3540408;Populina;2011;18;4,3;8;1,9;10;2,4
3541307;Presidente Epitácio;2011;78;1,9;68;1,6;10;0,2
3544905;Sales Oliveira;2011;29;2,7;19;1,8;10;0,9
3505807;Bastos;2011;35;1,7;28;1,4;7;0,3
3508603;Cachoeira Paulista;2011;47;1,6;40;1,3;7;0,2
3511706;Charqueada;2011;33;2,2;26;1,7;7;0,5
3512001;Colina;2011;47;2,7;40;2,3;7;0,4
3512308;Conchas;2011;44;2,7;37;2,3;7;0,4
3517802;Guaraçaí;2011;27;3,2;20;2,4;7;0,8
3518305;Guararema;2011;35;1,3;28;1,1;7;0,3
3519071;Hortolândia;2011;72;0,4;65;0,3;7;0,0
3523503;Itatinga;2011;14;0,8;7;0,4;7;0,4
3525508;Joanópolis;2011;24;2,0;17;1,4;7;0,6
3531803;Monte Mor;2011;45;0,9;38;0,8;7;0,1
3542404;Regente Feijó;2011;24;1,3;17;0,9;7;0,4
3502705;Apiaí;2011;47;1,9;41;1,6;6;0,2
3507902;Brotas;2011;41;1,9;35;1,6;6;0,3
3509304;Cajobi;2011;32;3,3;26;2,7;6;0,6
3514304;Dourado;2011;18;2,1;12;1,4;6;0,7
3536000;Parapuã;2011;32;3,0;26;2,4;6;0,6
3554300;Teodoro Sampaio;2011;58;2,7;52;2,4;6;0,3
3511508;Cerquilho;2011;39;1,0;31;0,8;8;0,2
3517703;Guará;2011;30;1,5;22;1,1;8;0,4
3520004;Igaraçu do Tietê;2011;63;2,7;55;2,3;8;0,3
3537909;Pilar do Sul;2011;35;1,3;27;1,0;8;0,3
3540804;Potirendaba;2011;28;1,8;20;1,3;8;0,5
3544251;Rosana;2011;66;3,4;58;3,0;8;0,4
3550902;São Simão;2011;40;2,8;32;2,2;8;0,6
3552106;Socorro;2011;62;1,7;54;1,5;8;0,2
3514502;Duartina;2011;82;6,7;77;6,3;5;0,4
3515202;Estrela d'Oeste;2011;14;1,7;9;1,1;5;0,6
3528809;Maracaí;2011;27;2,0;22;1,6;5;0,4
3532900;Nova Europa;2011;12;1,3;7;0,7;5;0,5
3553005;Taguaí;2011;16;1,4;11;1,0;5;0,5
3501301;Álvares Machado;2011;20;0,9;18;0,8;2;0,1
3503406;Arealva;2011;24;3,0;22;2,8;2;0,3
3506706;Boa Esperança do Sul;2011;15;1,1;13;0,9;2;0,1
3511003;Castilho;2011;11;0,6;9;0,5;2;0,1
3519105;Iacanga;2011;27;2,7;25;2,5;2;0,2
3535606;Paraibuna;2011;14;0,8;12;0,7;2;0,1
3527405;Lucélia;2011;67;3,4;48;2,4;19;1,0
3528106;Macaubal;2011;24;3,1;5;0,7;19;2,5
3535507;Paraguaçu Paulista;2011;97;2,3;78;1,8;19;0,4
3544004;Rio das Pedras;2011;60;2,0;41;1,4;19;0,6
3545407;Salto Grande;2011;34;3,9;15;1,7;19;2,2
3547700;Santo Anastácio;2011;56;2,7;37;1,8;19;0,9
3552601;Tabapuã;2011;30;2,6;11;1,0;19;1,7
3553807;Taquarituba;2011;55;2,5;36;1,6;19;0,8
3554805;Tremembé;2011;38;0,9;19;0,5;19;0,5
3556008;Urupês;2011;34;2,7;15;1,2;19;1,5
3509403;Cajuru;2011;68;2,9;50;2,1;18;0,8
3517406;Guaíra;2011;60;1,6;42;1,1;18;0,5
3519402;Ibirá;2011;27;2,5;9;0,8;18;1,6
3520103;Igarapava;2011;50;1,8;32;1,1;18;0,6
3533908;Olímpia;2011;94;1,9;76;1,5;18;0,4
3539509;Pitangueiras;2011;50;1,4;32;0,9;18;0,5
3536307;Patrocínio Paulista;2011;35;2,7;23;1,8;12;0,9
3542909;Ribeirão Bonito;2011;21;1,7;9;0,7;12;1,0
3546801;Santa Isabel;2011;100;2,0;88;1,7;12;0,2
3547601;Santa Rosa de Viterbo;2011;30;1,2;18;0,7;12;0,5
3550100;São Manuel;2011;34;0,9;22;0,6;12;0,3
3502754;Araçariguama;2011;4;0,2;0;0,0;4;0,2
3523602;Itirapina;2011;24;1,5;20;1,3;4;0,3
3525003;Jandira;2011;35;0,3;31;0,3;4;0,0
3537800;Piedade;2011;515;9,9;511;9,8;4;0,1
3539400;Piratininga;2011;30;2,5;26;2,1;4;0,3
3550803;São Sebastião da Grama;2011;30;2,5;26;2,2;4;0,3
3552403;Sumaré;2011;184;0,8;180;0,7;4;0,0
3501103;Alto Alegre;2011;22;5,4;19;4,6;3;0,7
3502200;Angatuba;2011;57;2,5;54;2,4;3;0,1
3520400;Ilhabela;2011;40;1,4;37;1,3;3;0,1
3527306;Louveira;2011;27;0,7;24;0,6;3;0,1
3534906;Pacaembu;2011;32;2,4;29;2,2;3;0,2
3545001;Salesópolis;2011;24;1,5;21;1,3;3;0,2
3508702;Caconde;2011;75;4,0;64;3,4;11;0,6
3508801;Cafelândia;2011;58;3,5;47;2,8;11;0,7
3512209;Conchal;2011;55;2,2;44;1,7;11;0,4
3522901;Itapuí;2011;33;2,7;22;1,8;11;0,9
3540606;Porto Feliz;2011;45;0,9;34;0,7;11;0,2
3541208;Presidente Bernardes;2011;51;3,8;40;2,9;11;0,8
3550704;São Sebastião;2011;110;1,5;99;1,3;11;0,1
3510708;Cardoso;2011;31;2,6;18;1,5;13;1,1
3511607;Cesário Lange;2011;30;1,9;17;1,1;13;0,8
3519006;Herculândia;2011;32;3,7;19;2,2;13;1,5
3528007;Macatuba;2011;31;1,9;18;1,1;13;0,8
3543808;Rinópolis;2011;33;3,3;20;2,0;13;1,3
3551603;Serra Negra;2011;55;2,1;42;1,6;13;0,5
3552700;Tabatinga;2011;35;2,4;22;1,5;13;0,9
3553302;Tambaú;2011;36;1,6;23;1,0;13;0,6
3553609;Tapiratiba;2011;34;2,7;21;1,7;13;1,0
3503703;Ariranha;2011;25;2,9;4;0,5;21;2,4
3506409;Bilac;2011;35;4,9;14;2,0;21;2,9
3514106;Dois Córregos;2011;65;2,6;44;1,8;21;0,8
3516606;Gália;2011;45;6,5;24;3,4;21;3,0
3516903;General Salgado;2011;32;3,0;11;1,0;21;2,0
3518602;Guariba;2011;72;2,0;51;1,4;21;0,6
3521903;Itajobi;2011;36;2,5;15;1,0;21;1,4
3525706;José Bonifácio;2011;61;1,8;40;1,2;21;0,6
3529708;Miguelópolis;2011;64;3,1;43;2,1;21;1,0
3546306;Santa Cruz das Palmeiras;2011;44;1,5;23;0,8;21;0,7
3501004;Altinópolis;2011;30;1,9;21;1,3;9;0,6
3511409;Cerqueira César;2011;42;2,4;33;1,9;9;0,5
3513900;Divinolândia;2011;204;18,3;195;17,4;9;0,8
3515400;Fartura;2011;26;1,7;17;1,1;9;0,6
3517000;Getulina;2011;51;4,7;42;3,9;9;0,8
3538808;Piraju;2011;80;2,8;71;2,5;9;0,3
3552007;Silveiras;2011;12;2,1;3;0,5;9;1,5
3508108;Buritama;2011;42;2,7;22;1,4;20;1,3
3521309;Ipuã;2011;48;3,4;28;2,0;20;1,4
3531506;Monte Azul Paulista;2011;67;3,6;47;2,5;20;1,1
3535408;Panorama;2011;65;4,4;45;3,1;20;1,4
3536703;Pederneiras;2011;67;1,6;47;1,1;20;0,5
3537008;Pedregulho;2011;52;3,3;32;2,0;20;1,3
3545605;Santa Adélia;2011;31;2,2;11;0,8;20;1,4
3536604;Paulo de Faria;2011;24;2,8;9;1,0;15;1,7
3550001;São Luiz do Paraitinga;2011;26;2,5;11;1,1;15;1,4
3551504;Serrana;2011;58;1,5;43;1,1;15;0,4
3500105;Adamantina;2011;308;9,1;271;8,0;37;1,1
3500303;Aguaí;2011;76;2,3;49;1,5;27;0,8
3500709;Agudos;2011;65;1,9;43;1,2;22;0,6
3501608;Americana;2011;677;3,2;373;1,8;304;1,4
3501905;Amparo;2011;456;6,9;356;5,4;100;1,5
3502101;Andradina;2011;100;1,8;64;1,2;36;0,6
3502507;Aparecida;2011;84;2,4;50;1,4;34;1,0
3502606;Aparecida d'Oeste;2011;30;6,8;8;1,8;22;5,0
3502804;Araçatuba;2011;660;3,6;495;2,7;165;0,9
3503208;Araraquara;2011;545;2,6;238;1,1;307;1,5
3503307;Araras;2011;1.144;9,5;696;5,8;448;3,7
3503802;Artur Nogueira;2011;56;1,2;0;0,0;56;1,2
3503901;Arujá;2011;82;1,1;15;0,2;67;0,9
3504008;Assis;2011;342;3,6;176;1,8;166;1,7
3504107;Atibaia;2011;187;1,5;48;0,4;139;1,1
3504503;Avaré;2011;153;1,8;95;1,1;58;0,7
3505203;Bariri;2011;68;2,1;52;1,6;16;0,5
3505302;Barra Bonita;2011;101;2,9;68;1,9;33;0,9
3505500;Barretos;2011;577;5,1;462;4,1;115;1,0
3505708;Barueri;2011;478;2,0;382;1,6;96;0,4
3505906;Batatais;2011;139;2,4;90;1,6;49;0,9
3506003;Bauru;2011;1.191;3,4;807;2,3;384;1,1
3506102;Bebedouro;2011;140;1,9;92;1,2;48;0,6
3506300;Bernardino de Campos;2011;50;4,6;16;1,5;34;3,2
3506508;Birigui;2011;262;2,4;170;1,5;92;0,8
3507001;Boituva;2011;55;1,1;39;0,8;16;0,3
3507506;Botucatu;2011;604;4,7;497;3,9;107;0,8
3507605;Bragança Paulista;2011;326;2,2;192;1,3;134;0,9
3508504;Caçapava;2011;132;1,5;63;0,7;69;0,8
3509007;Caieiras;2011;86;1,0;37;0,4;49;0,6
3509502;Campinas;2011;2.753;2,5;1.375;1,3;1.378;1,3
3509700;Campos do Jordão;2011;444;9,2;342;7,1;102;2,1
3510203;Capão Bonito;2011;95;2,1;70;1,5;25;0,5
3510401;Capivari;2011;119;2,4;58;1,2;61;1,2
3510500;Caraguatatuba;2011;158;1,5;120;1,2;38;0,4
3510807;Casa Branca;2011;412;14,5;395;13,9;17;0,6
3511102;Catanduva;2011;575;5,1;425;3,8;150;1,3
3512803;Cosmópolis;2011;90;1,5;61;1,0;29;0,5
3513009;Cotia;2011;253;1,2;189;0,9;64;0,3
3513405;Cruzeiro;2011;152;2,0;107;1,4;45;0,6
3513504;Cubatão;2011;150;1,3;134;1,1;16;0,1
3513603;Cunha;2011;40;1,8;24;1,1;16;0,7
3513702;Descalvado;2011;57;1,8;23;0,7;34;1,1
3513801;Diadema;2011;567;1,5;494;1,3;73;0,2
3514403;Dracena;2011;143;3,3;108;2,5;35;0,8
3515186;Espírito Santo do Pinhal;2011;465;11,1;373;8,9;92;2,2
3515509;Fernandópolis;2011;172;2,7;92;1,4;80;1,2
3516200;Franca;2011;678;2,1;418;1,3;260;0,8
3516309;Francisco Morato;2011;144;0,9;95;0,6;49;0,3
3516408;Franco da Rocha;2011;670;5,0;440;3,3;230;1,7
3516705;Garça;2011;376;8,7;331;7,7;45;1,0
3518404;Guaratinguetá;2011;316;2,8;274;2,4;42;0,4
3518701;Guarujá;2011;306;1,0;212;0,7;94;0,3
3518800;Guarulhos;2011;1.859;1,5;1.413;1,1;446;0,4
3519600;Ibitinga;2011;93;1,7;52;1,0;41;0,8
3520442;Ilha Solteira;2011;116;4,6;74;2,9;42;1,7
3520509;Indaiatuba;2011;326;1,6;230;1,1;96;0,5
3520707;Indiaporã;2011;40;10,3;5;1,3;35;9,0
3520905;Ipaussu;2011;49;3,6;21;1,5;28;2,0
3521804;Itaí;2011;41;1,7;40;1,7;1;0,0
3522208;Itapecerica da Serra;2011;472;3,1;282;1,8;190;1,2
3522307;Itapetininga;2011;129;0,9;93;0,6;36;0,2
3522406;Itapeva;2011;204;2,3;153;1,7;51;0,6
3522505;Itapevi;2011;254;1,2;205;1,0;49;0,2
3522604;Itapira;2011;1.452;21,1;839;12,2;613;8,9
3522703;Itápolis;2011;74;1,8;46;1,1;28;0,7
3522802;Itaporanga;2011;49;3,4;33;2,3;16;1,1
3523107;Itaquaquecetuba;2011;254;0,8;224;0,7;30;0,1
3523206;Itararé;2011;97;2,0;73;1,5;24;0,5
3523404;Itatiba;2011;112;1,1;60;0,6;52;0,5
3523909;Itu;2011;426;2,7;391;2,5;35;0,2
3524006;Itupeva;2011;86;1,9;48;1,0;38;0,8
3524105;Ituverava;2011;120;3,1;58;1,5;62;1,6
3524303;Jaboticabal;2011;122;1,7;51;0,7;71;1,0
3524402;Jacareí;2011;383;1,8;179;0,8;204;1,0
3524501;Jaci;2011;177;30,6;135;23,4;42;7,3
3524808;Jales;2011;129;2,7;70;1,5;59;1,3
3525300;Jaú;2011;922;7,0;735;5,5;187;1,4
3525904;Jundiaí;2011;640;1,7;281;0,8;359;1,0
3526001;Junqueirópolis;2011;52;2,8;26;1,4;26;1,4
3526407;Laranjal Paulista;2011;47;1,8;33;1,3;14;0,5
3526704;Leme;2011;127;1,4;76;0,8;51;0,6
3526803;Lençóis Paulista;2011;80;1,3;57;0,9;23;0,4
3526902;Limeira;2011;400;1,4;203;0,7;197;0,7
3527108;Lins;2011;484;6,7;379;5,3;105;1,5
3527207;Lorena;2011;160;1,9;90;1,1;70;0,8
3527702;Luiziânia;2011;32;6,3;15;2,9;17;3,3
3529005;Marília;2011;887;4,1;728;3,3;159;0,7
3529203;Martinópolis;2011;66;2,7;41;1,7;25;1,0
3529302;Matão;2011;140;1,8;84;1,1;56;0,7
3529401;Mauá;2011;442;1,0;236;0,6;206;0,5
3530102;Mirandópolis;2011;126;4,6;96;3,5;30;1,1
3530300;Mirassol;2011;93;1,7;24;0,4;69;1,3
3530508;Mococa;2011;140;2,1;98;1,5;42;0,6
3530607;Mogi das Cruzes;2011;742;1,9;551;1,4;191;0,5
3530706;Mogi Guaçu;2011;269;1,9;149;1,1;120;0,9
3530805;Mogi Mirim;2011;264;3,0;140;1,6;124;1,4
3531308;Monte Alto;2011;109;2,3;58;1,2;51;1,1
3531407;Monte Aprazível;2011;80;3,6;35;1,6;45;2,1
3531902;Morro Agudo;2011;45;1,5;31;1,1;14;0,5
3532504;Neves Paulista;2011;34;3,9;11;1,3;23;2,6
3532603;Nhandeara;2011;124;11,6;36;3,4;88;8,2
3533007;Nova Granada;2011;193;10,0;42;2,2;151;7,8
3533502;Novo Horizonte;2011;105;2,9;38;1,0;67;1,8
3534302;Orlândia;2011;118;2,9;72;1,8;46;1,1
3534401;Osasco;2011;950;1,4;616;0,9;334;0,5
3534609;Osvaldo Cruz;2011;118;3,8;71;2,3;47;1,5
3534708;Ourinhos;2011;315;3,0;230;2,2;85;0,8
3534757;Ouroeste;2011;39;4,6;10;1,2;29;3,4
3535200;Palmeira d'Oeste;2011;24;2,5;10;1,0;14;1,5
3535309;Palmital;2011;68;3,2;44;2,1;24;1,1
3537305;Penápolis;2011;241;4,1;168;2,9;73;1,2
3537404;Pereira Barreto;2011;98;3,9;65;2,6;33;1,3
3538006;Pindamonhangaba;2011;195;1,3;117;0,8;78;0,5
3538709;Piracicaba;2011;807;2,2;316;0,9;491;1,3
3538907;Pirajuí;2011;153;6,7;83;3,6;70;3,1
3539004;Pirangi;2011;37;3,5;9;0,8;28;2,6
3539301;Pirassununga;2011;86;1,2;52;0,7;34;0,5
3540200;Pontal;2011;75;1,8;45;1,1;30;0,7
3540705;Porto Ferreira;2011;61;1,2;37;0,7;24;0,5
3541000;Praia Grande;2011;199;0,7;113;0,4;86;0,3
3541406;Presidente Prudente;2011;1.578;7,6;1.094;5,2;484;2,3
3541505;Presidente Venceslau;2011;97;2,6;75;2,0;22;0,6
3542206;Rancharia;2011;98;3,4;70;2,4;28;1,0
3542602;Registro;2011;90;1,7;48;0,9;42;0,8
3543006;Ribeirão Branco;2011;39;2,1;38;2,1;1;0,1
3543303;Ribeirão Pires;2011;164;1,4;50;0,4;114;1,0
3543402;Ribeirão Preto;2011;1.920;3,1;1.365;2,2;555;0,9
3543907;Rio Claro;2011;488;2,6;270;1,4;218;1,2
3544202;Riolândia;2011;36;3,4;7;0,7;29;2,7
3545209;Salto;2011;123;1,2;69;0,6;54;0,5
3545308;Salto de Pirapora;2011;1.011;25,0;985;24,3;26;0,6
3545803;Santa Bárbara d'Oeste;2011;126;0,7;75;0,4;51;0,3
3546405;Santa Cruz do Rio Pardo;2011;102;2,3;59;1,3;43;1,0
3546603;Santa Fé do Sul;2011;76;2,6;33;1,1;43;1,5
3547502;Santa Rita do Passa Quatro;2011;299;11,3;276;10,4;23;0,9
3547809;Santo André;2011;1.450;2,1;604;0,9;846;1,2
3548500;Santos;2011;1.624;3,9;734;1,7;890;2,1
3548609;São Bento do Sapucaí;2011;40;3,8;24;2,3;16;1,5
3548708;São Bernardo do Campo;2011;1.631;2,1;761;1,0;870;1,1
3548807;São Caetano do Sul;2011;529;3,5;150;1,0;379;2,5
3548906;São Carlos;2011;443;2,0;204;0,9;239;1,1
3549102;São João da Boa Vista;2011;190;2,3;84;1,0;106;1,3
3549409;São Joaquim da Barra;2011;115;2,5;68;1,5;47;1,0
3549706;São José do Rio Pardo;2011;145;2,8;89;1,7;56;1,1
3549805;São José do Rio Preto;2011;1.690;4,1;1.146;2,8;544;1,3
3549904;São José dos Campos;2011;1.459;2,3;829;1,3;630;1,0
3550308;São Paulo;2011;29.497;2,6;15.657;1,4;13.840;1,2
3550407;São Pedro;2011;62;1,9;37;1,2;25;0,8
3550605;São Roque;2011;104;1,3;54;0,7;50;0,6
3551009;São Vicente;2011;218;0,7;166;0,5;52;0,2
3551702;Sertãozinho;2011;155;1,4;75;0,7;80;0,7
3552205;Sorocaba;2011;2.588;4,4;2.158;3,6;430;0,7
3552502;Suzano;2011;188;0,7;119;0,4;69;0,3
3552809;Taboão da Serra;2011;569;2,3;338;1,4;231;0,9
3553203;Taiúva;2011;11;1,9;10;1,7;1;0,2
3553401;Tanabi;2011;72;3,0;38;1,6;34;1,4
3553708;Taquaritinga;2011;163;3,0;119;2,2;44;0,8
3554003;Tatuí;2011;135;1,2;90;0,8;45;0,4
3554102;Taubaté;2011;499;1,8;299;1,1;200;0,7
3554508;Tietê;2011;60;1,6;35;0,9;25;0,7
3555000;Tupã;2011;872;13,8;798;12,6;74;1,2
3555406;Ubatuba;2011;92;1,2;68;0,9;24;0,3
3555802;Urânia;2011;38;4,3;9;1,0;29;3,3
3556206;Valinhos;2011;165;1,5;66;0,6;99;0,9
3556305;Valparaíso;2011;55;2,4;31;1,4;24;1,1
3556404;Vargem Grande do Sul;2011;88;2,2;53;1,3;35;0,9
3556701;Vinhedo;2011;95;1,5;59;0,9;36;0,6
3556800;Viradouro;2011;54;3,1;20;1,1;34;2,0
3557006;Votorantim;2011;146;1,3;84;0,8;62;0,6
3557105;Votuporanga;2011;240;2,8;118;1,4;122;1,4
3557204;Chavantes;2011;48;4,0;20;1,6;28;2,3
3500501;Águas de Lindóia;2011;42;2,4;30;1,7;12;0,7
3504206;Auriflama;2011;51;3,6;30;2,1;21;1,5
3506805;Bocaina;2011;35;3,2;30;2,7;5;0,5
3508405;Cabreúva;2011;38;0,9;30;0,7;8;0,2
3516002;Flórida Paulista;2011;47;3,7;30;2,4;17;1,3
3518206;Guararapes;2011;74;2,4;30;1,0;44;1,4
3521705;Itaberá;2011;35;2,0;30;1,7;5;0,3
3554409;Terra Roxa;2011;34;4,0;30;3,5;4;0,5
3555109;Tupi Paulista;2011;48;3,3;30;2,1;18;1,3
3500204;Adolfo;2010;0;0,0;0;0,0;0;0,0
3500402;Águas da Prata;2010;0;0,0;0;0,0;0;0,0
3500550;Águas de Santa Bárbara;2010;0;0,0;0;0,0;0;0,0
3500600;Águas de São Pedro;2010;0;0,0;0;0,0;0;0,0
3500758;Alambari;2010;0;0,0;0;0,0;0;0,0
3500808;Alfredo Marcondes;2010;0;0,0;0;0,0;0;0,0
3500907;Altair;2010;0;0,0;0;0,0;0;0,0
3501152;Alumínio;2010;0;0,0;0;0,0;0;0,0
3501202;Álvares Florence;2010;0;0,0;0;0,0;0;0,0
3501400;Álvaro de Carvalho;2010;0;0,0;0;0,0;0;0,0
3501509;Alvinlândia;2010;0;0,0;0;0,0;0;0,0
3501806;Américo de Campos;2010;0;0,0;0;0,0;0;0,0
3502002;Analândia;2010;0;0,0;0;0,0;0;0,0
3502309;Anhembi;2010;0;0,0;0;0,0;0;0,0
3502408;Anhumas;2010;0;0,0;0;0,0;0;0,0
3502903;Araçoiaba da Serra;2010;0;0,0;0;0,0;0;0,0
3503000;Aramina;2010;0;0,0;0;0,0;0;0,0
3503158;Arapeí;2010;0;0,0;0;0,0;0;0,0
3503356;Arco-Íris;2010;0;0,0;0;0,0;0;0,0
3503505;Areias;2010;0;0,0;0;0,0;0;0,0
3503604;Areiópolis;2010;0;0,0;0;0,0;0;0,0
3503950;Aspásia;2010;0;0,0;0;0,0;0;0,0
3504305;Avaí;2010;0;0,0;0;0,0;0;0,0
3504404;Avanhandava;2010;0;0,0;0;0,0;0;0,0
3504602;Bady Bassitt;2010;0;0,0;0;0,0;0;0,0
3504701;Balbinos;2010;0;0,0;0;0,0;0;0,0
3504800;Bálsamo;2010;0;0,0;0;0,0;0;0,0
3505005;Barão de Antonina;2010;0;0,0;0;0,0;0;0,0
3505104;Barbosa;2010;0;0,0;0;0,0;0;0,0
3505351;Barra do Chapéu;2010;0;0,0;0;0,0;0;0,0
3505401;Barra do Turvo;2010;0;0,0;0;0,0;0;0,0
3506201;Bento de Abreu;2010;0;0,0;0;0,0;0;0,0
3506904;Bofete;2010;0;0,0;0;0,0;0;0,0
3507159;Bom Sucesso de Itararé;2010;0;0,0;0;0,0;0;0,0
3507209;Borá;2010;0;0,0;0;0,0;0;0,0
3507308;Boracéia;2010;0;0,0;0;0,0;0;0,0
3507456;Borebi;2010;0;0,0;0;0,0;0;0,0
3507704;Braúna;2010;0;0,0;0;0,0;0;0,0
3507753;Brejo Alegre;2010;0;0,0;0;0,0;0;0,0
3507803;Brodowski;2010;0;0,0;0;0,0;0;0,0
3508009;Buri;2010;0;0,0;0;0,0;0;0,0
3508207;Buritizal;2010;0;0,0;0;0,0;0;0,0
3508306;Cabrália Paulista;2010;0;0,0;0;0,0;0;0,0
3508900;Caiabu;2010;0;0,0;0;0,0;0;0,0
3509106;Caiuá;2010;0;0,0;0;0,0;0;0,0
3509452;Campina do Monte Alegre;2010;0;0,0;0;0,0;0;0,0
3509809;Campos Novos Paulista;2010;0;0,0;0;0,0;0;0,0
3509908;Cananéia;2010;0;0,0;0;0,0;0;0,0
3509957;Canas;2010;0;0,0;0;0,0;0;0,0
3510104;Cândido Rodrigues;2010;0;0,0;0;0,0;0;0,0
3510153;Canitar;2010;0;0,0;0;0,0;0;0,0
3510302;Capela do Alto;2010;0;0,0;0;0,0;0;0,0
3510906;Cássia dos Coqueiros;2010;0;0,0;0;0,0;0;0,0
3511201;Catiguá;2010;0;0,0;0;0,0;0;0,0
3511300;Cedral;2010;0;0,0;0;0,0;0;0,0
3512407;Cordeirópolis;2010;0;0,0;0;0,0;0;0,0
3512506;Coroados;2010;0;0,0;0;0,0;0;0,0
3512605;Coronel Macedo;2010;0;0,0;0;0,0;0;0,0
3512704;Corumbataí;2010;0;0,0;0;0,0;0;0,0
3512902;Cosmorama;2010;0;0,0;0;0,0;0;0,0
3513207;Cristais Paulista;2010;0;0,0;0;0,0;0;0,0
3513306;Cruzália;2010;0;0,0;0;0,0;0;0,0
3513850;Dirce Reis;2010;0;0,0;0;0,0;0;0,0
3514007;Dobrada;2010;0;0,0;0;0,0;0;0,0
3514205;Dolcinópolis;2010;0;0,0;0;0,0;0;0,0
3514601;Dumont;2010;0;0,0;0;0,0;0;0,0
3514700;Echaporã;2010;0;0,0;0;0,0;0;0,0
3514924;Elisiário;2010;0;0,0;0;0,0;0;0,0
3514957;Embaúba;2010;0;0,0;0;0,0;0;0,0
3515129;Emilianópolis;2010;0;0,0;0;0,0;0;0,0
3515152;Engenheiro Coelho;2010;0;0,0;0;0,0;0;0,0
3515194;Espírito Santo do Turvo;2010;0;0,0;0;0,0;0;0,0
3515301;Estrela do Norte;2010;0;0,0;0;0,0;0;0,0
3515350;Euclides da Cunha Paulista;2010;0;0,0;0;0,0;0;0,0
3515608;Fernando Prestes;2010;0;0,0;0;0,0;0;0,0
3515657;Fernão;2010;0;0,0;0;0,0;0;0,0
3515806;Flora Rica;2010;0;0,0;0;0,0;0;0,0
3515905;Floreal;2010;0;0,0;0;0,0;0;0,0
3516101;Florínea;2010;0;0,0;0;0,0;0;0,0
3516507;Gabriel Monteiro;2010;0;0,0;0;0,0;0;0,0
3516804;Gastão Vidigal;2010;0;0,0;0;0,0;0;0,0
3516853;Gavião Peixoto;2010;0;0,0;0;0,0;0;0,0
3517109;Glicério;2010;0;0,0;0;0,0;0;0,0
3517208;Guaiçara;2010;0;0,0;0;0,0;0;0,0
3517307;Guaimbê;2010;0;0,0;0;0,0;0;0,0
3517505;Guapiaçu;2010;0;0,0;0;0,0;0;0,0
3517901;Guaraci;2010;0;0,0;0;0,0;0;0,0
3518008;Guarani d'Oeste;2010;0;0,0;0;0,0;0;0,0
3518503;Guareí;2010;0;0,0;0;0,0;0;0,0
3518859;Guatapará;2010;0;0,0;0;0,0;0;0,0
3518909;Guzolândia;2010;0;0,0;0;0,0;0;0,0
3519055;Holambra;2010;0;0,0;0;0,0;0;0,0
3519253;Iaras;2010;0;0,0;0;0,0;0;0,0
3519501;Ibirarema;2010;0;0,0;0;0,0;0;0,0
3519808;Icém;2010;0;0,0;0;0,0;0;0,0
3520426;Ilha Comprida;2010;0;0,0;0;0,0;0;0,0
3520608;Indiana;2010;0;0,0;0;0,0;0;0,0
3520806;Inúbia Paulista;2010;0;0,0;0;0,0;0;0,0
3521002;Iperó;2010;0;0,0;0;0,0;0;0,0
3521101;Ipeúna;2010;0;0,0;0;0,0;0;0,0
3521150;Ipiguá;2010;0;0,0;0;0,0;0;0,0
3521200;Iporanga;2010;0;0,0;0;0,0;0;0,0
3521408;Iracemápolis;2010;0;0,0;0;0,0;0;0,0
3521507;Irapuã;2010;0;0,0;0;0,0;0;0,0
3521606;Irapuru;2010;0;0,0;0;0,0;0;0,0
3522000;Itaju;2010;0;0,0;0;0,0;0;0,0
3522158;Itaoca;2010;0;0,0;0;0,0;0;0,0
3522653;Itapirapuã Paulista;2010;0;0,0;0;0,0;0;0,0
3523008;Itapura;2010;0;0,0;0;0,0;0;0,0
3523305;Itariri;2010;0;0,0;0;0,0;0;0,0
3523701;Itirapuã;2010;0;0,0;0;0,0;0;0,0
3523800;Itobi;2010;0;0,0;0;0,0;0;0,0
3524600;Jacupiranga;2010;0;0,0;0;0,0;0;0,0
3524907;Jambeiro;2010;0;0,0;0;0,0;0;0,0
3525102;Jardinópolis;2010;0;0,0;0;0,0;0;0,0
3525409;Jeriquara;2010;0;0,0;0;0,0;0;0,0
3525607;João Ramalho;2010;0;0,0;0;0,0;0;0,0
3525805;Júlio Mesquita;2010;0;0,0;0;0,0;0;0,0
3525854;Jumirim;2010;0;0,0;0;0,0;0;0,0
3526308;Lagoinha;2010;0;0,0;0;0,0;0;0,0
3526506;Lavínia;2010;0;0,0;0;0,0;0;0,0
3526605;Lavrinhas;2010;0;0,0;0;0,0;0;0,0
3527009;Lindóia;2010;0;0,0;0;0,0;0;0,0
3527256;Lourdes;2010;0;0,0;0;0,0;0;0,0
3527504;Lucianópolis;2010;0;0,0;0;0,0;0;0,0
3527603;Luís Antônio;2010;0;0,0;0;0,0;0;0,0
3527801;Lupércio;2010;0;0,0;0;0,0;0;0,0
3527900;Lutécia;2010;0;0,0;0;0,0;0;0,0
3528205;Macedônia;2010;0;0,0;0;0,0;0;0,0
3528304;Magda;2010;0;0,0;0;0,0;0;0,0
3528403;Mairinque;2010;0;0,0;0;0,0;0;0,0
3528601;Manduri;2010;0;0,0;0;0,0;0;0,0
3528700;Marabá Paulista;2010;0;0,0;0;0,0;0;0,0
3528858;Marapoama;2010;0;0,0;0;0,0;0;0,0
3528908;Mariápolis;2010;0;0,0;0;0,0;0;0,0
3529104;Marinópolis;2010;0;0,0;0;0,0;0;0,0
3529500;Mendonça;2010;0;0,0;0;0,0;0;0,0
3529609;Meridiano;2010;0;0,0;0;0,0;0;0,0
3529658;Mesópolis;2010;0;0,0;0;0,0;0;0,0
3529807;Mineiros do Tietê;2010;0;0,0;0;0,0;0;0,0
3530003;Mira Estrela;2010;0;0,0;0;0,0;0;0,0
3530201;Mirante do Paranapanema;2010;0;0,0;0;0,0;0;0,0
3530409;Mirassolândia;2010;0;0,0;0;0,0;0;0,0
3530904;Mombuca;2010;0;0,0;0;0,0;0;0,0
3531001;Monções;2010;0;0,0;0;0,0;0;0,0
3531209;Monte Alegre do Sul;2010;0;0,0;0;0,0;0;0,0
3531605;Monte Castelo;2010;0;0,0;0;0,0;0;0,0
3531704;Monteiro Lobato;2010;0;0,0;0;0,0;0;0,0
3532058;Motuca;2010;0;0,0;0;0,0;0;0,0
3532157;Nantes;2010;0;0,0;0;0,0;0;0,0
3532207;Narandiba;2010;0;0,0;0;0,0;0;0,0
3532306;Natividade da Serra;2010;0;0,0;0;0,0;0;0,0
3532702;Nipoã;2010;0;0,0;0;0,0;0;0,0
3532801;Nova Aliança;2010;0;0,0;0;0,0;0;0,0
3532827;Nova Campina;2010;0;0,0;0;0,0;0;0,0
3532843;Nova Canaã Paulista;2010;0;0,0;0;0,0;0;0,0
3532868;Nova Castilho;2010;0;0,0;0;0,0;0;0,0
3533106;Nova Guataporanga;2010;0;0,0;0;0,0;0;0,0
3533205;Nova Independência;2010;0;0,0;0;0,0;0;0,0
3533254;Novais;2010;0;0,0;0;0,0;0;0,0
3533304;Nova Luzitânia;2010;0;0,0;0;0,0;0;0,0
3533601;Nuporanga;2010;0;0,0;0;0,0;0;0,0
3533700;Ocauçu;2010;0;0,0;0;0,0;0;0,0
3533809;Óleo;2010;0;0,0;0;0,0;0;0,0
3534005;Onda Verde;2010;0;0,0;0;0,0;0;0,0
3534104;Oriente;2010;0;0,0;0;0,0;0;0,0
3534203;Orindiúva;2010;0;0,0;0;0,0;0;0,0
3534500;Oscar Bressane;2010;0;0,0;0;0,0;0;0,0
3534807;Ouro Verde;2010;0;0,0;0;0,0;0;0,0
3535002;Palestina;2010;0;0,0;0;0,0;0;0,0
3535101;Palmares Paulista;2010;0;0,0;0;0,0;0;0,0
3535705;Paraíso;2010;0;0,0;0;0,0;0;0,0
3535903;Paranapuã;2010;0;0,0;0;0,0;0;0,0
3536109;Pardinho;2010;0;0,0;0;0,0;0;0,0
3536257;Parisi;2010;0;0,0;0;0,0;0;0,0
3536406;Paulicéia;2010;0;0,0;0;0,0;0;0,0
3536570;Paulistânia;2010;0;0,0;0;0,0;0;0,0
3536802;Pedra Bela;2010;0;0,0;0;0,0;0;0,0
3536901;Pedranópolis;2010;0;0,0;0;0,0;0;0,0
3537156;Pedrinhas Paulista;2010;0;0,0;0;0,0;0;0,0
3537206;Pedro de Toledo;2010;0;0,0;0;0,0;0;0,0
3537503;Pereiras;2010;0;0,0;0;0,0;0;0,0
3537701;Piacatu;2010;0;0,0;0;0,0;0;0,0
3538105;Pindorama;2010;0;0,0;0;0,0;0;0,0
3538204;Pinhalzinho;2010;0;0,0;0;0,0;0;0,0
3538303;Piquerobi;2010;0;0,0;0;0,0;0;0,0
3538501;Piquete;2010;0;0,0;0;0,0;0;0,0
3539103;Pirapora do Bom Jesus;2010;0;0,0;0;0,0;0;0,0
3539608;Planalto;2010;0;0,0;0;0,0;0;0,0
3539707;Platina;2010;0;0,0;0;0,0;0;0,0
3539905;Poloni;2010;0;0,0;0;0,0;0;0,0
3540101;Pongaí;2010;0;0,0;0;0,0;0;0,0
3540259;Pontalinda;2010;0;0,0;0;0,0;0;0,0
3540309;Pontes Gestal;2010;0;0,0;0;0,0;0;0,0
3540507;Porangaba;2010;0;0,0;0;0,0;0;0,0
3540754;Potim;2010;0;0,0;0;0,0;0;0,0
3540853;Pracinha;2010;0;0,0;0;0,0;0;0,0
3540903;Pradópolis;2010;0;0,0;0;0,0;0;0,0
3541059;Pratânia;2010;0;0,0;0;0,0;0;0,0
3541109;Presidente Alves;2010;0;0,0;0;0,0;0;0,0
3541653;Quadra;2010;0;0,0;0;0,0;0;0,0
3541703;Quatá;2010;0;0,0;0;0,0;0;0,0
3541802;Queiroz;2010;0;0,0;0;0,0;0;0,0
3542008;Quintana;2010;0;0,0;0;0,0;0;0,0
3542107;Rafard;2010;0;0,0;0;0,0;0;0,0
3542305;Redenção da Serra;2010;0;0,0;0;0,0;0;0,0
3542503;Reginópolis;2010;0;0,0;0;0,0;0;0,0
3542701;Restinga;2010;0;0,0;0;0,0;0;0,0
3542800;Ribeira;2010;0;0,0;0;0,0;0;0,0
3543105;Ribeirão Corrente;2010;0;0,0;0;0,0;0;0,0
3543204;Ribeirão do Sul;2010;0;0,0;0;0,0;0;0,0
3543238;Ribeirão dos Índios;2010;0;0,0;0;0,0;0;0,0
3543253;Ribeirão Grande;2010;0;0,0;0;0,0;0;0,0
3543501;Riversul;2010;0;0,0;0;0,0;0;0,0
3543600;Rifaina;2010;0;0,0;0;0,0;0;0,0
3543709;Rincão;2010;0;0,0;0;0,0;0;0,0
3544103;Rio Grande da Serra;2010;0;0,0;0;0,0;0;0,0
3544400;Rubiácea;2010;0;0,0;0;0,0;0;0,0
3544509;Rubinéia;2010;0;0,0;0;0,0;0;0,0
3544608;Sabino;2010;0;0,0;0;0,0;0;0,0
3544707;Sagres;2010;0;0,0;0;0,0;0;0,0
3544806;Sales;2010;0;0,0;0;0,0;0;0,0
3545100;Salmourão;2010;0;0,0;0;0,0;0;0,0
3545159;Saltinho;2010;0;0,0;0;0,0;0;0,0
3545506;Sandovalina;2010;0;0,0;0;0,0;0;0,0
3545704;Santa Albertina;2010;0;0,0;0;0,0;0;0,0
3546009;Santa Branca;2010;0;0,0;0;0,0;0;0,0
3546108;Santa Clara d'Oeste;2010;0;0,0;0;0,0;0;0,0
3546207;Santa Cruz da Conceição;2010;0;0,0;0;0,0;0;0,0
3546256;Santa Cruz da Esperança;2010;0;0,0;0;0,0;0;0,0
3546504;Santa Ernestina;2010;0;0,0;0;0,0;0;0,0
3546702;Santa Gertrudes;2010;0;0,0;0;0,0;0;0,0
3546900;Santa Lúcia;2010;0;0,0;0;0,0;0;0,0
3547106;Santa Mercedes;2010;0;0,0;0;0,0;0;0,0
3547205;Santana da Ponte Pensa;2010;0;0,0;0;0,0;0;0,0
3547403;Santa Rita d'Oeste;2010;0;0,0;0;0,0;0;0,0
3547650;Santa Salete;2010;0;0,0;0;0,0;0;0,0
3548005;Santo Antônio de Posse;2010;0;0,0;0;0,0;0;0,0
3548054;Santo Antônio do Aracanguá;2010;0;0,0;0;0,0;0;0,0
3548104;Santo Antônio do Jardim;2010;0;0,0;0;0,0;0;0,0
3548203;Santo Antônio do Pinhal;2010;0;0,0;0;0,0;0;0,0
3548302;Santo Expedito;2010;0;0,0;0;0,0;0;0,0
3548401;Santópolis do Aguapeí;2010;0;0,0;0;0,0;0;0,0
3549003;São Francisco;2010;0;0,0;0;0,0;0;0,0
3549201;São João das Duas Pontes;2010;0;0,0;0;0,0;0;0,0
3549250;São João de Iracema;2010;0;0,0;0;0,0;0;0,0
3549300;São João do Pau d'Alho;2010;0;0,0;0;0,0;0;0,0
3549508;São José da Bela Vista;2010;0;0,0;0;0,0;0;0,0
3549607;São José do Barreiro;2010;0;0,0;0;0,0;0;0,0
3549953;São Lourenço da Serra;2010;0;0,0;0;0,0;0;0,0
3550506;São Pedro do Turvo;2010;0;0,0;0;0,0;0;0,0
3551108;Sarapuí;2010;0;0,0;0;0,0;0;0,0
3551207;Sarutaiá;2010;0;0,0;0;0,0;0;0,0
3551306;Sebastianópolis do Sul;2010;0;0,0;0;0,0;0;0,0
3551405;Serra Azul;2010;0;0,0;0;0,0;0;0,0
3551801;Sete Barras;2010;0;0,0;0;0,0;0;0,0
3551900;Severínia;2010;0;0,0;0;0,0;0;0,0
3552551;Suzanápolis;2010;0;0,0;0;0,0;0;0,0
3552908;Taciba;2010;0;0,0;0;0,0;0;0,0
3553104;Taiaçu;2010;0;0,0;0;0,0;0;0,0
3553500;Tapiraí;2010;0;0,0;0;0,0;0;0,0
3553658;Taquaral;2010;0;0,0;0;0,0;0;0,0
3553856;Taquarivaí;2010;0;0,0;0;0,0;0;0,0
3553906;Tarabai;2010;0;0,0;0;0,0;0;0,0
3553955;Tarumã;2010;0;0,0;0;0,0;0;0,0
3554201;Tejupá;2010;0;0,0;0;0,0;0;0,0
3554607;Timburi;2010;0;0,0;0;0,0;0;0,0
3554656;Torre de Pedra;2010;0;0,0;0;0,0;0;0,0
3554755;Trabiju;2010;0;0,0;0;0,0;0;0,0
3554904;Três Fronteiras;2010;0;0,0;0;0,0;0;0,0
3554953;Tuiuti;2010;0;0,0;0;0,0;0;0,0
3555208;Turiúba;2010;0;0,0;0;0,0;0;0,0
3555307;Turmalina;2010;0;0,0;0;0,0;0;0,0
3555356;Ubarana;2010;0;0,0;0;0,0;0;0,0
3555505;Ubirajara;2010;0;0,0;0;0,0;0;0,0
3555604;Uchoa;2010;0;0,0;0;0,0;0;0,0
3555703;União Paulista;2010;0;0,0;0;0,0;0;0,0
3555901;Uru;2010;0;0,0;0;0,0;0;0,0
3556107;Valentim Gentil;2010;0;0,0;0;0,0;0;0,0
3556354;Vargem;2010;0;0,0;0;0,0;0;0,0
3556453;Vargem Grande Paulista;2010;0;0,0;0;0,0;0;0,0
3556602;Vera Cruz;2010;0;0,0;0;0,0;0;0,0
3556958;Vitória Brasil;2010;0;0,0;0;0,0;0;0,0
3557154;Zacarias;2010;0;0,0;0;0,0;0;0,0
3557303;Estiva Gerbi;2010;0;0,0;0;0,0;0;0,0
3501707;Américo Brasiliense;2010;240;7,0;240;7,0;0;0,0
3503109;Arandu;2010;16;2,6;16;2,6;0;0,0
3504909;Bananal;2010;15;1,5;15;1,5;0;0,0
3505609;Barrinha;2010;29;1,0;29;1,0;0;0,0
3506359;Bertioga;2010;51;1,1;51;1,1;0;0,0
3506607;Biritiba Mirim;2010;14;0,5;14;0,5;0;0,0
3507100;Bom Jesus dos Perdões;2010;11;0,6;11;0,6;0;0,0
3509205;Cajamar;2010;71;1,1;71;1,1;0;0,0
3509254;Cajati;2010;13;0,5;13;0,5;0;0,0
3509601;Campo Limpo Paulista;2010;44;0,6;44;0,6;0;0,0
3512100;Colômbia;2010;20;3,3;20;3,3;0;0,0
3513108;Cravinhos;2010;23;0,7;23;0,7;0;0,0
3514809;Eldorado;2010;7;0,5;7;0,5;0;0,0
3514908;Elias Fausto;2010;6;0,4;6;0,4;0;0,0
3515004;Embu das Artes;2010;81;0,3;81;0,3;0;0,0
3515103;Embu-Guaçu;2010;21;0,3;21;0,3;0;0,0
3515707;Ferraz de Vasconcelos;2010;189;1,1;189;1,1;0;0,0
3517604;Guapiara;2010;18;1,0;18;1,0;0;0,0
3519204;Iacri;2010;15;2,3;15;2,3;0;0,0
3519709;Ibiúna;2010;16;0,2;16;0,2;0;0,0
3519907;Iepê;2010;20;2,6;20;2,6;0;0,0
3520004;Igaraçu do Tietê;2010;67;2,9;67;2,9;0;0,0
3520202;Igaratá;2010;15;1,7;15;1,7;0;0,0
3520301;Iguape;2010;34;1,2;34;1,2;0;0,0
3521804;Itaí;2010;40;1,7;40;1,7;0;0,0
3522109;Itanhaém;2010;71;0,8;71;0,8;0;0,0
3524204;Jaborandi;2010;23;3,5;23;3,5;0;0,0
3524709;Jaguariúna;2010;75;1,7;75;1,7;0;0,0
3525201;Jarinu;2010;11;0,5;11;0,5;0;0,0
3525508;Joanópolis;2010;19;1,6;19;1,6;0;0,0
3526100;Juquiá;2010;13;0,7;13;0,7;0;0,0
3526209;Juquitiba;2010;24;0,8;24;0,8;0;0,0
3528502;Mairiporã;2010;47;0,6;47;0,6;0;0,0
3529906;Miracatu;2010;16;0,8;16;0,8;0;0,0
3531100;Mongaguá;2010;44;1,0;44;1,0;0;0,0
3532108;Murutinga do Sul;2010;22;5,3;22;5,3;0;0,0
3532405;Nazaré Paulista;2010;24;1,5;24;1,5;0;0,0
3533403;Nova Odessa;2010;50;1,0;50;1,0;0;0,0
3535804;Paranapanema;2010;30;1,7;30;1,7;0;0,0
3536208;Pariquera-Açu;2010;159;8,6;159;8,6;0;0,0
3537602;Peruíbe;2010;44;0,7;44;0,7;0;0,0
3539202;Pirapozinho;2010;59;2,4;59;2,4;0;0,0
3539806;Poá;2010;24;0,2;24;0,2;0;0,0
3540002;Pompéia;2010;41;2,1;41;2,1;0;0,0
3541604;Promissão;2010;78;2,2;78;2,2;0;0,0
3544301;Roseira;2010;14;1,5;14;1,5;0;0,0
3547007;Santa Maria da Serra;2010;5;0,9;5;0,9;0;0,0
3547304;Santana de Parnaíba;2010;28;0,3;28;0,3;0;0,0
3547908;Santo Antônio da Alegria;2010;12;1,9;12;1,9;0;0,0
3550209;São Miguel Arcanjo;2010;6;0,2;6;0,2;0;0,0
3552106;Socorro;2010;62;1,7;62;1,7;0;0,0
3552304;Sud Mennucci;2010;20;2,7;20;2,7;0;0,0
3554706;Torrinha;2010;20;2,1;20;2,1;0;0,0
3556503;Várzea Paulista;2010;31;0,3;31;0,3;0;0,0
3556909;Vista Alegre do Alto;2010;13;1,9;13;1,9;0;0,0
3507407;Borborema;2010;26;1,8;16;1,1;10;0,7
3510005;Cândido Mota;2010;50;1,7;40;1,3;10;0,3
3511904;Clementina;2010;30;4,3;20;2,8;10;1,4
3532009;Morungaba;2010;27;2,3;17;1,4;10;0,9
3537107;Pedreira;2010;49;1,2;39;0,9;10;0,2
3538600;Piracaia;2010;35;1,4;25;1,0;10;0,4
3540408;Populina;2010;18;4,3;8;1,9;10;2,4
3541307;Presidente Epitácio;2010;78;1,9;68;1,6;10;0,2
3541901;Queluz;2010;38;3,4;28;2,5;10;0,9
3544905;Sales Oliveira;2010;29;2,7;19;1,8;10;0,9
3508603;Cachoeira Paulista;2010;47;1,6;40;1,3;7;0,2
3511706;Charqueada;2010;33;2,2;26;1,7;7;0,5
3512001;Colina;2010;47;2,7;40;2,3;7;0,4
3512308;Conchas;2010;44;2,7;37;2,3;7;0,4
3517802;Guaraçaí;2010;27;3,2;20;2,4;7;0,8
3518305;Guararema;2010;35;1,4;28;1,1;7;0,3
3519071;Hortolândia;2010;75;0,4;68;0,4;7;0,0
3523503;Itatinga;2010;14;0,8;7;0,4;7;0,4
3531803;Monte Mor;2010;45;0,9;38;0,8;7;0,1
3542404;Regente Feijó;2010;24;1,3;17;0,9;7;0,4
3502705;Apiaí;2010;52;2,1;46;1,8;6;0,2
3507902;Brotas;2010;41;1,9;35;1,6;6;0,3
3509304;Cajobi;2010;32;3,3;26;2,7;6;0,6
3514304;Dourado;2010;18;2,1;12;1,4;6;0,7
3536000;Parapuã;2010;32;3,0;26;2,4;6;0,6
3554300;Teodoro Sampaio;2010;58;2,7;52;2,4;6;0,3
3508405;Cabreúva;2010;36;0,9;28;0,7;8;0,2
3511508;Cerquilho;2010;39;1,0;31;0,8;8;0,2
3537909;Pilar do Sul;2010;35;1,3;27;1,0;8;0,3
3540804;Potirendaba;2010;28;1,8;20;1,3;8;0,5
3544251;Rosana;2010;66;3,3;58;2,9;8;0,4
3550902;São Simão;2010;40;2,8;32;2,2;8;0,6
3514502;Duartina;2010;82;6,7;77;6,3;5;0,4
3515202;Estrela d'Oeste;2010;14;1,7;9;1,1;5;0,6
3519303;Ibaté;2010;67;2,2;62;2,0;5;0,2
3528809;Maracaí;2010;27;2,0;22;1,7;5;0,4
3532900;Nova Europa;2010;12;1,3;7;0,8;5;0,5
3553005;Taguaí;2010;16;1,5;11;1,0;5;0,5
3501301;Álvares Machado;2010;20;0,9;18;0,8;2;0,1
3503406;Arealva;2010;24;3,1;22;2,8;2;0,3
3506706;Boa Esperança do Sul;2010;15;1,1;13;1,0;2;0,1
3519105;Iacanga;2010;27;2,7;25;2,5;2;0,2
3527405;Lucélia;2010;67;3,4;48;2,4;19;1,0
3528106;Macaubal;2010;24;3,1;5;0,7;19;2,5
3535507;Paraguaçu Paulista;2010;97;2,3;78;1,8;19;0,4
3544004;Rio das Pedras;2010;60;2,0;41;1,4;19;0,6
3545407;Salto Grande;2010;34;3,9;15;1,7;19;2,2
3547700;Santo Anastácio;2010;56;2,7;37;1,8;19;0,9
3550407;São Pedro;2010;81;2,6;62;2,0;19;0,6
3552601;Tabapuã;2010;30;2,6;11;1,0;19;1,7
3554805;Tremembé;2010;38;0,9;19;0,5;19;0,5
3556008;Urupês;2010;34;2,7;15;1,2;19;1,5
3506409;Bilac;2010;30;4,3;12;1,7;18;2,6
3509403;Cajuru;2010;68;2,9;50;2,1;18;0,8
3517406;Guaíra;2010;60;1,6;42;1,1;18;0,5
3519402;Ibirá;2010;27;2,5;9;0,8;18;1,7
3520103;Igarapava;2010;50;1,8;32;1,1;18;0,6
3533908;Olímpia;2010;94;1,9;76;1,5;18;0,4
3536505;Paulínia;2010;102;1,2;84;1,0;18;0,2
3553807;Taquarituba;2010;53;2,4;35;1,6;18;0,8
3536307;Patrocínio Paulista;2010;35;2,7;23;1,8;12;0,9
3542909;Ribeirão Bonito;2010;21;1,7;9;0,7;12;1,0
3546801;Santa Isabel;2010;100;2,0;88;1,7;12;0,2
3547601;Santa Rosa de Viterbo;2010;30;1,3;18;0,8;12;0,5
3502754;Araçariguama;2010;4;0,2;0;0,0;4;0,2
3505807;Bastos;2010;61;3,0;57;2,8;4;0,2
3518107;Guarantã;2010;28;4,4;24;3,7;4;0,6
3519006;Herculândia;2010;23;2,6;19;2,2;4;0,5
3523602;Itirapina;2010;24;1,5;20;1,3;4;0,3
3537800;Piedade;2010;515;9,9;511;9,8;4;0,1
3539400;Piratininga;2010;30;2,5;26;2,2;4;0,3
3550803;São Sebastião da Grama;2010;30;2,5;26;2,1;4;0,3
3552403;Sumaré;2010;184;0,8;180;0,7;4;0,0
3501103;Alto Alegre;2010;22;5,4;19;4,6;3;0,7
3502200;Angatuba;2010;57;2,6;54;2,4;3;0,1
3520400;Ilhabela;2010;40;1,4;37;1,3;3;0,1
3527306;Louveira;2010;27;0,7;24;0,6;3;0,1
3534906;Pacaembu;2010;32;2,4;29;2,2;3;0,2
3545001;Salesópolis;2010;24;1,5;21;1,3;3;0,2
3508702;Caconde;2010;75;4,0;64;3,5;11;0,6
3508801;Cafelândia;2010;58;3,5;47;2,8;11;0,7
3522901;Itapuí;2010;33;2,7;22;1,8;11;0,9
3540606;Porto Feliz;2010;45;0,9;34;0,7;11;0,2
3541208;Presidente Bernardes;2010;51;3,8;40;2,9;11;0,8
3550704;São Sebastião;2010;110;1,5;99;1,3;11;0,1
3510708;Cardoso;2010;31;2,6;18;1,5;13;1,1
3511607;Cesário Lange;2010;30;1,9;17;1,1;13;0,8
3528007;Macatuba;2010;31;1,9;18;1,1;13;0,8
3535606;Paraibuna;2010;24;1,4;11;0,6;13;0,7
3537008;Pedregulho;2010;51;3,2;38;2,4;13;0,8
3543808;Rinópolis;2010;33;3,3;20;2,0;13;1,3
3552700;Tabatinga;2010;35;2,4;22;1,5;13;0,9
3553302;Tambaú;2010;36;1,6;23;1,0;13;0,6
3553609;Tapiratiba;2010;34;2,7;21;1,6;13;1,0
3503703;Ariranha;2010;25;2,9;4;0,5;21;2,5
3514106;Dois Córregos;2010;65;2,6;44;1,8;21;0,8
3516606;Gália;2010;45;6,4;24;3,4;21;3,0
3516903;General Salgado;2010;32;3,0;11;1,0;21;2,0
3518602;Guariba;2010;72;2,0;51;1,4;21;0,6
3521903;Itajobi;2010;36;2,5;15;1,0;21;1,4
3525706;José Bonifácio;2010;61;1,9;40;1,2;21;0,6
3529708;Miguelópolis;2010;64;3,1;43;2,1;21;1,0
3501004;Altinópolis;2010;30;1,9;21;1,3;9;0,6
3511409;Cerqueira César;2010;42;2,4;33;1,9;9;0,5
3513900;Divinolândia;2010;204;18,2;195;17,4;9;0,8
3515400;Fartura;2010;26;1,7;17;1,1;9;0,6
3517000;Getulina;2010;51;4,7;42;3,9;9;0,8
3538808;Piraju;2010;80;2,8;71;2,5;9;0,3
3552007;Silveiras;2010;12;2,1;3;0,5;9;1,6
3521309;Ipuã;2010;48;3,4;28;2,0;20;1,4
3535408;Panorama;2010;65;4,5;45;3,1;20;1,4
3536703;Pederneiras;2010;67;1,6;47;1,1;20;0,5
3545605;Santa Adélia;2010;31;2,2;11;0,8;20;1,4
3536604;Paulo de Faria;2010;24;2,8;9;1,0;15;1,7
3550001;São Luiz do Paraitinga;2010;26;2,5;11;1,1;15;1,4
3551504;Serrana;2010;58;1,5;43;1,1;15;0,4
3500105;Adamantina;2010;308;9,1;271;8,0;37;1,1
3500303;Aguaí;2010;76;2,4;49;1,5;27;0,8
3500709;Agudos;2010;65;1,9;43;1,2;22;0,6
3501608;Americana;2010;619;2,9;388;1,8;231;1,1
3501905;Amparo;2010;454;6,9;356;5,4;98;1,5
3502101;Andradina;2010;100;1,8;64;1,2;36;0,7
3502507;Aparecida;2010;84;2,4;50;1,4;34;1,0
3502606;Aparecida d'Oeste;2010;30;6,7;8;1,8;22;4,9
3502804;Araçatuba;2010;660;3,6;495;2,7;165;0,9
3503208;Araraquara;2010;504;2,4;238;1,1;266;1,3
3503307;Araras;2010;1.137;9,6;539;4,5;598;5,0
3503802;Artur Nogueira;2010;56;1,3;0;0,0;56;1,3
3503901;Arujá;2010;76;1,0;9;0,1;67;0,9
3504008;Assis;2010;346;3,6;181;1,9;165;1,7
3504107;Atibaia;2010;187;1,5;48;0,4;139;1,1
3504503;Avaré;2010;153;1,8;95;1,1;58;0,7
3505203;Bariri;2010;68;2,2;52;1,6;16;0,5
3505302;Barra Bonita;2010;101;2,9;68;1,9;33;0,9
3505500;Barretos;2010;577;5,2;457;4,1;120;1,1
3505708;Barueri;2010;465;1,9;382;1,6;83;0,3
3505906;Batatais;2010;139;2,5;90;1,6;49;0,9
3506003;Bauru;2010;1.148;3,3;802;2,3;346;1,0
3506102;Bebedouro;2010;123;1,6;75;1,0;48;0,6
3506300;Bernardino de Campos;2010;50;4,6;16;1,5;34;3,2
3506508;Birigui;2010;251;2,3;170;1,6;81;0,7
3507001;Boituva;2010;58;1,2;42;0,9;16;0,3
3507506;Botucatu;2010;713;5,6;590;4,6;123;1,0
3507605;Bragança Paulista;2010;326;2,2;192;1,3;134;0,9
3508108;Buritama;2010;36;2,3;22;1,4;14;0,9
3508504;Caçapava;2010;123;1,5;67;0,8;56;0,7
3509007;Caieiras;2010;91;1,1;29;0,3;62;0,7
3509502;Campinas;2010;2.764;2,6;1.407;1,3;1.357;1,3
3509700;Campos do Jordão;2010;444;9,3;322;6,7;122;2,6
3510203;Capão Bonito;2010;100;2,2;75;1,6;25;0,5
3510401;Capivari;2010;119;2,5;58;1,2;61;1,3
3510500;Caraguatatuba;2010;160;1,6;122;1,2;38;0,4
3510609;Carapicuíba;2010;271;0,7;228;0,6;43;0,1
3510807;Casa Branca;2010;457;16,2;440;15,6;17;0,6
3511102;Catanduva;2010;575;5,1;425;3,8;150;1,3
3512209;Conchal;2010;60;2,4;44;1,7;16;0,6
3512803;Cosmópolis;2010;90;1,5;61;1,0;29;0,5
3513009;Cotia;2010;240;1,2;176;0,9;64;0,3
3513405;Cruzeiro;2010;152;2,0;107;1,4;45;0,6
3513504;Cubatão;2010;150;1,3;134;1,1;16;0,1
3513603;Cunha;2010;40;1,8;24;1,1;16;0,7
3513702;Descalvado;2010;57;1,8;23;0,7;34;1,1
3513801;Diadema;2010;565;1,5;492;1,3;73;0,2
3514403;Dracena;2010;143;3,3;108;2,5;35;0,8
3515186;Espírito Santo do Pinhal;2010;465;11,1;373;8,9;92;2,2
3515509;Fernandópolis;2010;172;2,7;92;1,4;80;1,2
3516200;Franca;2010;678;2,1;418;1,3;260;0,8
3516309;Francisco Morato;2010;144;0,9;95;0,6;49;0,3
3516408;Franco da Rocha;2010;635;4,8;405;3,1;230;1,8
3516705;Garça;2010;376;8,7;331;7,7;45;1,0
3518404;Guaratinguetá;2010;316;2,8;274;2,4;42;0,4
3518701;Guarujá;2010;356;1,2;259;0,9;97;0,3
3518800;Guarulhos;2010;1.954;1,6;1.429;1,2;525;0,4
3519600;Ibitinga;2010;93;1,8;52;1,0;41;0,8
3520442;Ilha Solteira;2010;116;4,6;74;3,0;42;1,7
3520509;Indaiatuba;2010;318;1,6;211;1,0;107;0,5
3520707;Indiaporã;2010;40;10,2;5;1,3;35;9,0
3520905;Ipaussu;2010;49;3,6;21;1,5;28;2,1
3522208;Itapecerica da Serra;2010;472;3,1;282;1,9;190;1,2
3522307;Itapetininga;2010;127;0,9;79;0,5;48;0,3
3522406;Itapeva;2010;204;2,3;153;1,7;51;0,6
3522505;Itapevi;2010;246;1,2;216;1,1;30;0,1
3522604;Itapira;2010;1.448;21,1;855;12,5;593;8,7
3522703;Itápolis;2010;74;1,8;43;1,1;31;0,8
3522802;Itaporanga;2010;49;3,4;33;2,3;16;1,1
3523107;Itaquaquecetuba;2010;254;0,8;224;0,7;30;0,1
3523206;Itararé;2010;97;2,0;73;1,5;24;0,5
3523404;Itatiba;2010;102;1,0;57;0,6;45;0,4
3523909;Itu;2010;503;3,3;391;2,5;112;0,7
3524006;Itupeva;2010;86;1,9;48;1,1;38;0,9
3524105;Ituverava;2010;124;3,2;62;1,6;62;1,6
3524303;Jaboticabal;2010;141;2,0;59;0,8;82;1,1
3524402;Jacareí;2010;418;2,0;199;0,9;219;1,0
3524501;Jaci;2010;177;31,4;135;23,9;42;7,4
3524808;Jales;2010;119;2,5;70;1,5;49;1,0
3525003;Jandira;2010;166;1,5;70;0,6;96;0,9
3525300;Jaú;2010;923;7,1;728;5,6;195;1,5
3525904;Jundiaí;2010;652;1,8;280;0,8;372;1,0
3526001;Junqueirópolis;2010;52;2,8;26;1,4;26;1,4
3526407;Laranjal Paulista;2010;47;1,9;33;1,3;14;0,6
3526704;Leme;2010;127;1,4;76;0,8;51;0,6
3526803;Lençóis Paulista;2010;80;1,3;55;0,9;25;0,4
3526902;Limeira;2010;411;1,5;209;0,8;202;0,7
3527108;Lins;2010;524;7,3;419;5,9;105;1,5
3527207;Lorena;2010;160;1,9;90;1,1;70;0,8
3527702;Luiziânia;2010;32;6,4;15;3,0;17;3,4
3529005;Marília;2010;993;4,6;755;3,5;238;1,1
3529203;Martinópolis;2010;66;2,7;41;1,7;25;1,0
3529302;Matão;2010;140;1,8;84;1,1;56;0,7
3529401;Mauá;2010;442;1,1;236;0,6;206;0,5
3530102;Mirandópolis;2010;126;4,6;96;3,5;30;1,1
3530300;Mirassol;2010;93;1,7;24;0,4;69;1,3
3530508;Mococa;2010;135;2,0;98;1,5;37;0,6
3530607;Mogi das Cruzes;2010;787;2,0;556;1,4;231;0,6
3530706;Mogi Guaçu;2010;269;2,0;149;1,1;120;0,9
3530805;Mogi Mirim;2010;227;2,6;138;1,6;89;1,0
3531308;Monte Alto;2010;104;2,2;57;1,2;47;1,0
3531407;Monte Aprazível;2010;80;3,7;35;1,6;45;2,1
3531506;Monte Azul Paulista;2010;71;3,7;48;2,5;23;1,2
3531902;Morro Agudo;2010;45;1,5;31;1,1;14;0,5
3532504;Neves Paulista;2010;34;3,9;11;1,3;23;2,6
3532603;Nhandeara;2010;124;11,6;36;3,4;88;8,2
3533007;Nova Granada;2010;193;10,1;42;2,2;151;7,9
3533502;Novo Horizonte;2010;105;2,9;38;1,0;67;1,8
3534302;Orlândia;2010;118;3,0;72;1,8;46;1,2
3534401;Osasco;2010;910;1,4;509;0,8;401;0,6
3534609;Osvaldo Cruz;2010;118;3,8;71;2,3;47;1,5
3534708;Ourinhos;2010;296;2,9;221;2,1;75;0,7
3534757;Ouroeste;2010;39;4,7;10;1,2;29;3,5
3535200;Palmeira d'Oeste;2010;24;2,5;10;1,0;14;1,5
3535309;Palmital;2010;68;3,2;44;2,1;24;1,1
3537305;Penápolis;2010;245;4,2;172;2,9;73;1,2
3537404;Pereira Barreto;2010;98;3,9;65;2,6;33;1,3
3538006;Pindamonhangaba;2010;204;1,4;122;0,8;82;0,6
3538709;Piracicaba;2010;683;1,9;293;0,8;390;1,1
3538907;Pirajuí;2010;153;6,7;83;3,7;70;3,1
3539004;Pirangi;2010;37;3,5;9;0,8;28;2,6
3539301;Pirassununga;2010;110;1,6;54;0,8;56;0,8
3539509;Pitangueiras;2010;50;1,4;33;0,9;17;0,5
3540200;Pontal;2010;75;1,9;42;1,0;33;0,8
3540705;Porto Ferreira;2010;61;1,2;37;0,7;24;0,5
3541000;Praia Grande;2010;208;0,8;156;0,6;52;0,2
3541406;Presidente Prudente;2010;1.588;7,7;1.079;5,2;509;2,5
3541505;Presidente Venceslau;2010;97;2,6;75;2,0;22;0,6
3542206;Rancharia;2010;98;3,4;70;2,4;28;1,0
3542602;Registro;2010;90;1,7;48;0,9;42;0,8
3543006;Ribeirão Branco;2010;39;2,1;38;2,1;1;0,1
3543303;Ribeirão Pires;2010;128;1,1;45;0,4;83;0,7
3543402;Ribeirão Preto;2010;1.896;3,1;1.347;2,2;549;0,9
3543907;Rio Claro;2010;456;2,5;276;1,5;180;1,0
3544202;Riolândia;2010;36;3,4;7;0,7;29;2,7
3545209;Salto;2010;99;0,9;55;0,5;44;0,4
3545308;Salto de Pirapora;2010;1.011;25,2;985;24,6;26;0,6
3545803;Santa Bárbara d'Oeste;2010;126;0,7;75;0,4;51;0,3
3546306;Santa Cruz das Palmeiras;2010;46;1,5;24;0,8;22;0,7
3546405;Santa Cruz do Rio Pardo;2010;102;2,3;59;1,3;43;1,0
3546603;Santa Fé do Sul;2010;76;2,6;33;1,1;43;1,5
3547502;Santa Rita do Passa Quatro;2010;299;11,3;276;10,4;23;0,9
3547809;Santo André;2010;1.491;2,2;637;0,9;854;1,3
3548500;Santos;2010;1.692;4,0;816;1,9;876;2,1
3548609;São Bento do Sapucaí;2010;40;3,8;24;2,3;16;1,5
3548708;São Bernardo do Campo;2010;1.721;2,2;836;1,1;885;1,2
3548807;São Caetano do Sul;2010;661;4,4;218;1,5;443;3,0
3548906;São Carlos;2010;443;2,0;204;0,9;239;1,1
3549102;São João da Boa Vista;2010;190;2,3;84;1,0;106;1,3
3549409;São Joaquim da Barra;2010;120;2,6;92;2,0;28;0,6
3549706;São José do Rio Pardo;2010;145;2,8;89;1,7;56;1,1
3549805;São José do Rio Preto;2010;1.537;3,8;1.000;2,5;537;1,3
3549904;São José dos Campos;2010;1.467;2,3;856;1,4;611;1,0
3550100;São Manuel;2010;75;2,0;58;1,5;17;0,4
3550308;São Paulo;2010;29.562;2,6;15.708;1,4;13.854;1,2
3550605;São Roque;2010;94;1,2;54;0,7;40;0,5
3551009;São Vicente;2010;174;0,5;134;0,4;40;0,1
3551603;Serra Negra;2010;65;2,5;49;1,9;16;0,6
3551702;Sertãozinho;2010;155;1,4;75;0,7;80;0,7
3552205;Sorocaba;2010;2.583;4,4;2.158;3,7;425;0,7
3552502;Suzano;2010;330;1,3;217;0,8;113;0,4
3552809;Taboão da Serra;2010;572;2,3;338;1,4;234;1,0
3553203;Taiúva;2010;11;2,0;10;1,8;1;0,2
3553401;Tanabi;2010;72;3,0;38;1,6;34;1,4
3553708;Taquaritinga;2010;163;3,0;119;2,2;44;0,8
3554003;Tatuí;2010;135;1,3;90;0,8;45;0,4
3554102;Taubaté;2010;484;1,7;287;1,0;197;0,7
3554508;Tietê;2010;60;1,6;35;1,0;25;0,7
3555000;Tupã;2010;881;13,9;830;13,1;51;0,8
3555406;Ubatuba;2010;92;1,2;68;0,9;24;0,3
3555802;Urânia;2010;38;4,3;9;1,0;29;3,3
3556206;Valinhos;2010;165;1,5;66;0,6;99;0,9
3556305;Valparaíso;2010;55;2,4;31;1,4;24;1,1
3556404;Vargem Grande do Sul;2010;88;2,2;53;1,4;35;0,9
3556701;Vinhedo;2010;95;1,5;59;0,9;36;0,6
3556800;Viradouro;2010;54;3,1;20;1,2;34;2,0
3557006;Votorantim;2010;171;1,6;84;0,8;87;0,8
3557105;Votuporanga;2010;256;3,0;118;1,4;138;1,6
3557204;Chavantes;2010;48;4,0;20;1,7;28;2,3
3500501;Águas de Lindóia;2010;42;2,4;30;1,7;12;0,7
3504206;Auriflama;2010;51;3,6;30;2,1;21;1,5
3506805;Bocaina;2010;35;3,2;30;2,8;5;0,5
3511003;Castilho;2010;46;2,6;30;1,7;16;0,9
3516002;Flórida Paulista;2010;47;3,7;30;2,3;17;1,3
3517703;Guará;2010;38;1,9;30;1,5;8;0,4
3518206;Guararapes;2010;74;2,4;30;1,0;44;1,4
3521705;Itaberá;2010;35;2,0;30;1,7;5;0,3
3554409;Terra Roxa;2010;34;4,0;30;3,5;4;0,5
3555109;Tupi Paulista;2010;48;3,4;30;2,1;18;1,3
